Chain	ctx11	ctx12	ctx13	ctx21	ctx22	ctx23	STD	TC	diff
t22	1	2	3	4	5	6	146	146	0
t23	1	2	3	4	5	6	466	466	0
t11	1	2	3	4	5	6	10	10	0
t12	1	2	3	4	5	6	12	12	0
t13	1	2	3	4	5	6	34	34	0
t21	1	2	3	4	5	6	73	73	0
t22	1	2	3	4	6	5	424	244	180
t23	1	2	3	4	6	5	216	147	69
t11	1	2	3	4	6	5	10	10	0
t12	1	2	3	4	6	5	12	12	0
t13	1	2	3	4	6	5	34	34	0
t21	1	2	3	4	6	5	73	73	0
t22	1	2	3	5	4	6	407	151	256
t23	1	2	3	5	4	6	1462	466	996
t11	1	2	3	5	4	6	10	10	0
t12	1	2	3	5	4	6	12	12	0
t13	1	2	3	5	4	6	34	34	0
t21	1	2	3	5	4	6	695	155	540
t22	1	2	3	5	6	4	1007	265	742
t23	1	2	3	5	6	4	310	125	185
t11	1	2	3	5	6	4	10	10	0
t12	1	2	3	5	6	4	12	12	0
t13	1	2	3	5	6	4	34	34	0
t21	1	2	3	5	6	4	473	94	379
t22	1	2	3	6	4	5	0	191	-191
t23	1	2	3	6	4	5	0	183	-183
t11	1	2	3	6	4	5	0	10	-10
t12	1	2	3	6	4	5	0	12	-12
t13	1	2	3	6	4	5	0	34	-34
t21	1	2	3	6	4	5	0	213	-213
t22	1	2	3	6	5	4	0	212	-212
t23	1	2	3	6	5	4	0	142	-142
t11	1	2	3	6	5	4	0	10	-10
t12	1	2	3	6	5	4	0	12	-12
t13	1	2	3	6	5	4	0	34	-34
t21	1	2	3	6	5	4	0	213	-213
t22	1	2	4	3	5	6	133	133	0
t23	1	2	4	3	5	6	390	390	0
t11	1	2	4	3	5	6	10	10	0
t12	1	2	4	3	5	6	12	12	0
t13	1	2	4	3	5	6	47	47	0
t21	1	2	4	3	5	6	29	29	0
t22	1	2	4	3	6	5	343	200	143
t23	1	2	4	3	6	5	190	147	43
t11	1	2	4	3	6	5	10	10	0
t12	1	2	4	3	6	5	12	12	0
t13	1	2	4	3	6	5	47	47	0
t21	1	2	4	3	6	5	29	29	0
t22	1	2	4	5	3	6	187	65	122
t23	1	2	4	5	3	6	1445	459	986
t11	1	2	4	5	3	6	10	10	0
t12	1	2	4	5	3	6	12	12	0
t13	1	2	4	5	3	6	264	55	209
t21	1	2	4	5	3	6	695	155	540
t22	1	2	4	5	6	3	1007	265	742
t23	1	2	4	5	6	3	126	45	81
t11	1	2	4	5	6	3	10	10	0
t12	1	2	4	5	6	3	12	12	0
t13	1	2	4	5	6	3	210	49	161
t21	1	2	4	5	6	3	473	94	379
t22	1	2	4	6	3	5	0	87	-87
t23	1	2	4	6	3	5	0	166	-166
t11	1	2	4	6	3	5	0	10	-10
t12	1	2	4	6	3	5	0	12	-12
t13	1	2	4	6	3	5	0	55	-55
t21	1	2	4	6	3	5	0	213	-213
t22	1	2	4	6	5	3	0	212	-212
t23	1	2	4	6	5	3	0	58	-58
t11	1	2	4	6	5	3	0	10	-10
t12	1	2	4	6	5	3	0	12	-12
t13	1	2	4	6	5	3	0	49	-49
t21	1	2	4	6	5	3	0	213	-213
t22	1	2	5	3	4	6	50	50	0
t23	1	2	5	3	4	6	326	326	0
t11	1	2	5	3	4	6	10	10	0
t12	1	2	5	3	4	6	12	12	0
t13	1	2	5	3	4	6	79	79	0
t21	1	2	5	3	4	6	29	29	0
t22	1	2	5	3	6	4	343	200	143
t23	1	2	5	3	6	4	61	58	3
t11	1	2	5	3	6	4	10	10	0
t12	1	2	5	3	6	4	12	12	0
t13	1	2	5	3	6	4	113	54	59
t21	1	2	5	3	6	4	29	29	0
t22	1	2	5	4	3	6	35	35	0
t23	1	2	5	4	3	6	373	373	0
t11	1	2	5	4	3	6	10	10	0
t12	1	2	5	4	3	6	12	12	0
t13	1	2	5	4	3	6	89	89	0
t21	1	2	5	4	3	6	50	50	0
t22	1	2	5	4	6	3	446	205	241
t23	1	2	5	4	6	3	59	45	14
t11	1	2	5	4	6	3	10	10	0
t12	1	2	5	4	6	3	12	12	0
t13	1	2	5	4	6	3	128	54	74
t21	1	2	5	4	6	3	95	34	61
t22	1	2	5	6	3	4	0	87	-87
t23	1	2	5	6	3	4	0	66	-66
t11	1	2	5	6	3	4	0	10	-10
t12	1	2	5	6	3	4	0	12	-12
t13	1	2	5	6	3	4	0	70	-70
t21	1	2	5	6	3	4	0	213	-213
t22	1	2	5	6	4	3	0	92	-92
t23	1	2	5	6	4	3	0	45	-45
t11	1	2	5	6	4	3	0	10	-10
t12	1	2	5	6	4	3	0	12	-12
t13	1	2	5	6	4	3	0	70	-70
t21	1	2	5	6	4	3	0	213	-213
t22	1	2	6	3	4	5	50	50	0
t23	1	2	6	3	4	5	55	55	0
t11	1	2	6	3	4	5	10	10	0
t12	1	2	6	3	4	5	12	12	0
t13	1	2	6	3	4	5	133	133	0
t21	1	2	6	3	4	5	29	29	0
t22	1	2	6	3	5	4	72	72	0
t23	1	2	6	3	5	4	47	47	0
t11	1	2	6	3	5	4	10	10	0
t12	1	2	6	3	5	4	12	12	0
t13	1	2	6	3	5	4	134	134	0
t21	1	2	6	3	5	4	29	29	0
t22	1	2	6	4	3	5	35	35	0
t23	1	2	6	4	3	5	86	86	0
t11	1	2	6	4	3	5	10	10	0
t12	1	2	6	4	3	5	12	12	0
t13	1	2	6	4	3	5	138	138	0
t21	1	2	6	4	3	5	50	50	0
t22	1	2	6	4	5	3	72	72	0
t23	1	2	6	4	5	3	42	42	0
t11	1	2	6	4	5	3	10	10	0
t12	1	2	6	4	5	3	12	12	0
t13	1	2	6	4	5	3	139	134	5
t21	1	2	6	4	5	3	51	34	17
t22	1	2	6	5	3	4	65	58	7
t23	1	2	6	5	3	4	107	65	42
t11	1	2	6	5	3	4	10	10	0
t12	1	2	6	5	3	4	12	12	0
t13	1	2	6	5	3	4	195	155	40
t21	1	2	6	5	3	4	131	93	38
t22	1	2	6	5	4	3	111	65	46
t23	1	2	6	5	4	3	45	42	3
t11	1	2	6	5	4	3	10	10	0
t12	1	2	6	5	4	3	12	12	0
t13	1	2	6	5	4	3	210	155	55
t21	1	2	6	5	4	3	146	93	53
t22	1	3	2	4	5	6	252	146	106
t23	1	3	2	4	5	6	753	466	287
t11	1	3	2	4	5	6	10	10	0
t12	1	3	2	4	5	6	84	40	44
t13	1	3	2	4	5	6	42	28	14
t21	1	3	2	4	5	6	133	73	60
t22	1	3	2	4	6	5	684	244	440
t23	1	3	2	4	6	5	346	147	199
t11	1	3	2	4	6	5	10	10	0
t12	1	3	2	4	6	5	84	40	44
t13	1	3	2	4	6	5	42	28	14
t21	1	3	2	4	6	5	133	73	60
t22	1	3	2	5	4	6	779	151	628
t23	1	3	2	5	4	6	2909	466	2443
t11	1	3	2	5	4	6	10	10	0
t12	1	3	2	5	4	6	84	40	44
t13	1	3	2	5	4	6	42	28	14
t21	1	3	2	5	4	6	1393	155	1238
t22	1	3	2	5	6	4	1682	265	1417
t23	1	3	2	5	6	4	538	125	413
t11	1	3	2	5	6	4	10	10	0
t12	1	3	2	5	6	4	84	40	44
t13	1	3	2	5	6	4	42	28	14
t21	1	3	2	5	6	4	812	94	718
t22	1	3	2	6	4	5	0	191	-191
t23	1	3	2	6	4	5	0	183	-183
t11	1	3	2	6	4	5	0	10	-10
t12	1	3	2	6	4	5	0	40	-40
t13	1	3	2	6	4	5	0	28	-28
t21	1	3	2	6	4	5	0	213	-213
t22	1	3	2	6	5	4	0	212	-212
t23	1	3	2	6	5	4	0	142	-142
t11	1	3	2	6	5	4	0	10	-10
t12	1	3	2	6	5	4	0	40	-40
t13	1	3	2	6	5	4	0	28	-28
t21	1	3	2	6	5	4	0	213	-213
t22	1	3	4	2	5	6	133	133	0
t23	1	3	4	2	5	6	348	348	0
t11	1	3	4	2	5	6	10	10	0
t12	1	3	4	2	5	6	21	21	0
t13	1	3	4	2	5	6	47	47	0
t21	1	3	4	2	5	6	13	13	0
t22	1	3	4	2	6	5	371	184	187
t23	1	3	4	2	6	5	211	138	73
t11	1	3	4	2	6	5	10	10	0
t12	1	3	4	2	6	5	21	21	0
t13	1	3	4	2	6	5	47	47	0
t21	1	3	4	2	6	5	13	13	0
t22	1	3	4	5	2	6	0	47	-47
t23	1	3	4	5	2	6	0	453	-453
t11	1	3	4	5	2	6	0	10	-10
t12	1	3	4	5	2	6	0	31	-31
t13	1	3	4	5	2	6	0	67	-67
t21	1	3	4	5	2	6	0	155	-155
t22	1	3	4	5	6	2	0	265	-265
t23	1	3	4	5	6	2	0	27	-27
t11	1	3	4	5	6	2	0	10	-10
t12	1	3	4	5	6	2	0	27	-27
t13	1	3	4	5	6	2	0	51	-51
t21	1	3	4	5	6	2	0	94	-94
t22	1	3	4	6	2	5	0	65	-65
t23	1	3	4	6	2	5	0	166	-166
t11	1	3	4	6	2	5	0	10	-10
t12	1	3	4	6	2	5	0	31	-31
t13	1	3	4	6	2	5	0	67	-67
t21	1	3	4	6	2	5	0	213	-213
t22	1	3	4	6	5	2	0	212	-212
t23	1	3	4	6	5	2	0	38	-38
t11	1	3	4	6	5	2	0	10	-10
t12	1	3	4	6	5	2	0	27	-27
t13	1	3	4	6	5	2	0	51	-51
t21	1	3	4	6	5	2	0	213	-213
t22	1	3	5	2	4	6	50	50	0
t23	1	3	5	2	4	6	310	310	0
t11	1	3	5	2	4	6	10	10	0
t12	1	3	5	2	4	6	21	21	0
t13	1	3	5	2	4	6	81	81	0
t21	1	3	5	2	4	6	13	13	0
t22	1	3	5	2	6	4	371	184	187
t23	1	3	5	2	6	4	69	49	20
t11	1	3	5	2	6	4	10	10	0
t12	1	3	5	2	6	4	21	21	0
t13	1	3	5	2	6	4	121	57	64
t21	1	3	5	2	6	4	13	13	0
t22	1	3	5	4	2	6	29	29	0
t23	1	3	5	4	2	6	406	367	39
t11	1	3	5	4	2	6	10	10	0
t12	1	3	5	4	2	6	31	31	0
t13	1	3	5	4	2	6	97	97	0
t21	1	3	5	4	2	6	50	50	0
t22	1	3	5	4	6	2	803	205	598
t23	1	3	5	4	6	2	63	27	36
t11	1	3	5	4	6	2	10	10	0
t12	1	3	5	4	6	2	112	27	85
t13	1	3	5	4	6	2	238	66	172
t21	1	3	5	4	6	2	151	34	117
t22	1	3	5	6	2	4	0	65	-65
t23	1	3	5	6	2	4	0	66	-66
t11	1	3	5	6	2	4	0	10	-10
t12	1	3	5	6	2	4	0	31	-31
t13	1	3	5	6	2	4	0	82	-82
t21	1	3	5	6	2	4	0	213	-213
t22	1	3	5	6	4	2	0	92	-92
t23	1	3	5	6	4	2	0	27	-27
t11	1	3	5	6	4	2	0	10	-10
t12	1	3	5	6	4	2	0	27	-27
t13	1	3	5	6	4	2	0	82	-82
t21	1	3	5	6	4	2	0	213	-213
t22	1	3	6	2	4	5	50	50	0
t23	1	3	6	2	4	5	55	55	0
t11	1	3	6	2	4	5	10	10	0
t12	1	3	6	2	4	5	21	21	0
t13	1	3	6	2	4	5	124	124	0
t21	1	3	6	2	4	5	13	13	0
t22	1	3	6	2	5	4	72	72	0
t23	1	3	6	2	5	4	34	34	0
t11	1	3	6	2	5	4	10	10	0
t12	1	3	6	2	5	4	21	21	0
t13	1	3	6	2	5	4	136	136	0
t21	1	3	6	2	5	4	13	13	0
t22	1	3	6	4	2	5	29	29	0
t23	1	3	6	4	2	5	86	86	0
t11	1	3	6	4	2	5	10	10	0
t12	1	3	6	4	2	5	31	31	0
t13	1	3	6	4	2	5	157	157	0
t21	1	3	6	4	2	5	50	50	0
t22	1	3	6	4	5	2	72	72	0
t23	1	3	6	4	5	2	26	26	0
t11	1	3	6	4	5	2	10	10	0
t12	1	3	6	4	5	2	32	27	5
t13	1	3	6	4	5	2	159	149	10
t21	1	3	6	4	5	2	51	34	17
t22	1	3	6	5	2	4	47	40	7
t23	1	3	6	5	2	4	107	65	42
t11	1	3	6	5	2	4	10	10	0
t12	1	3	6	5	2	4	50	31	19
t13	1	3	6	5	2	4	215	174	41
t21	1	3	6	5	2	4	131	93	38
t22	1	3	6	5	4	2	111	65	46
t23	1	3	6	5	4	2	27	26	1
t11	1	3	6	5	4	2	10	10	0
t12	1	3	6	5	4	2	47	27	20
t13	1	3	6	5	4	2	233	170	63
t21	1	3	6	5	4	2	146	93	53
t22	1	4	2	3	5	6	331	133	198
t23	1	4	2	3	5	6	936	348	588
t11	1	4	2	3	5	6	10	10	0
t12	1	4	2	3	5	6	144	43	101
t13	1	4	2	3	5	6	70	31	39
t21	1	4	2	3	5	6	129	27	102
t22	1	4	2	3	6	5	852	198	654
t23	1	4	2	3	6	5	478	147	331
t11	1	4	2	3	6	5	10	10	0
t12	1	4	2	3	6	5	144	43	101
t13	1	4	2	3	6	5	70	31	39
t21	1	4	2	3	6	5	129	27	102
t22	1	4	2	5	3	6	0	51	-51
t23	1	4	2	5	3	6	0	457	-457
t11	1	4	2	5	3	6	0	10	-10
t12	1	4	2	5	3	6	0	49	-49
t13	1	4	2	5	3	6	0	40	-40
t21	1	4	2	5	3	6	0	155	-155
t22	1	4	2	5	6	3	0	265	-265
t23	1	4	2	5	6	3	0	41	-41
t11	1	4	2	5	6	3	0	10	-10
t12	1	4	2	5	6	3	0	45	-45
t13	1	4	2	5	6	3	0	33	-33
t21	1	4	2	5	6	3	0	94	-94
t22	1	4	2	6	3	5	0	69	-69
t23	1	4	2	6	3	5	0	166	-166
t11	1	4	2	6	3	5	0	10	-10
t12	1	4	2	6	3	5	0	49	-49
t13	1	4	2	6	3	5	0	40	-40
t21	1	4	2	6	3	5	0	213	-213
t22	1	4	2	6	5	3	0	212	-212
t23	1	4	2	6	5	3	0	42	-42
t11	1	4	2	6	5	3	0	10	-10
t12	1	4	2	6	5	3	0	45	-45
t13	1	4	2	6	5	3	0	33	-33
t21	1	4	2	6	5	3	0	213	-213
t22	1	4	3	2	5	6	272	133	139
t23	1	4	3	2	5	6	734	348	386
t11	1	4	3	2	5	6	10	10	0
t12	1	4	3	2	5	6	144	43	101
t13	1	4	3	2	5	6	73	34	39
t21	1	4	3	2	5	6	13	13	0
t22	1	4	3	2	6	5	683	184	499
t23	1	4	3	2	6	5	425	138	287
t11	1	4	3	2	6	5	10	10	0
t12	1	4	3	2	6	5	144	43	101
t13	1	4	3	2	6	5	73	34	39
t21	1	4	3	2	6	5	13	13	0
t22	1	4	3	5	2	6	0	47	-47
t23	1	4	3	5	2	6	0	453	-453
t11	1	4	3	5	2	6	0	10	-10
t12	1	4	3	5	2	6	0	49	-49
t13	1	4	3	5	2	6	0	50	-50
t21	1	4	3	5	2	6	0	155	-155
t22	1	4	3	5	6	2	0	265	-265
t23	1	4	3	5	6	2	0	27	-27
t11	1	4	3	5	6	2	0	10	-10
t12	1	4	3	5	6	2	0	45	-45
t13	1	4	3	5	6	2	0	43	-43
t21	1	4	3	5	6	2	0	94	-94
t22	1	4	3	6	2	5	0	65	-65
t23	1	4	3	6	2	5	0	166	-166
t11	1	4	3	6	2	5	0	10	-10
t12	1	4	3	6	2	5	0	49	-49
t13	1	4	3	6	2	5	0	50	-50
t21	1	4	3	6	2	5	0	213	-213
t22	1	4	3	6	5	2	0	212	-212
t23	1	4	3	6	5	2	0	38	-38
t11	1	4	3	6	5	2	0	10	-10
t12	1	4	3	6	5	2	0	45	-45
t13	1	4	3	6	5	2	0	43	-43
t21	1	4	3	6	5	2	0	213	-213
t22	1	4	5	2	3	6	32	32	0
t23	1	4	5	2	3	6	351	292	59
t11	1	4	5	2	3	6	10	10	0
t12	1	4	5	2	3	6	40	40	0
t13	1	4	5	2	3	6	100	100	0
t21	1	4	5	2	3	6	13	13	0
t22	1	4	5	2	6	3	492	184	308
t23	1	4	5	2	6	3	53	31	22
t11	1	4	5	2	6	3	10	10	0
t12	1	4	5	2	6	3	81	30	51
t13	1	4	5	2	6	3	163	66	97
t21	1	4	5	2	6	3	13	13	0
t22	1	4	5	3	2	6	29	29	0
t23	1	4	5	3	2	6	388	308	80
t11	1	4	5	3	2	6	10	10	0
t12	1	4	5	3	2	6	40	40	0
t13	1	4	5	3	2	6	100	100	0
t21	1	4	5	3	2	6	32	32	0
t22	1	4	5	3	6	2	771	199	572
t23	1	4	5	3	6	2	63	27	36
t11	1	4	5	3	6	2	10	10	0
t12	1	4	5	3	6	2	113	30	83
t13	1	4	5	3	6	2	239	66	173
t21	1	4	5	3	6	2	108	28	80
t22	1	4	5	6	2	3	0	65	-65
t23	1	4	5	6	2	3	0	46	-46
t11	1	4	5	6	2	3	0	10	-10
t12	1	4	5	6	2	3	0	46	-46
t13	1	4	5	6	2	3	0	86	-86
t21	1	4	5	6	2	3	0	213	-213
t22	1	4	5	6	3	2	0	70	-70
t23	1	4	5	6	3	2	0	27	-27
t11	1	4	5	6	3	2	0	10	-10
t12	1	4	5	6	3	2	0	46	-46
t13	1	4	5	6	3	2	0	86	-86
t21	1	4	5	6	3	2	0	213	-213
t22	1	4	6	2	3	5	32	32	0
t23	1	4	6	2	3	5	55	55	0
t11	1	4	6	2	3	5	10	10	0
t12	1	4	6	2	3	5	40	40	0
t13	1	4	6	2	3	5	139	139	0
t21	1	4	6	2	3	5	13	13	0
t22	1	4	6	2	5	3	72	72	0
t23	1	4	6	2	5	3	28	28	0
t11	1	4	6	2	5	3	10	10	0
t12	1	4	6	2	5	3	41	30	11
t13	1	4	6	2	5	3	145	145	0
t21	1	4	6	2	5	3	13	13	0
t22	1	4	6	3	2	5	29	29	0
t23	1	4	6	3	2	5	55	55	0
t11	1	4	6	3	2	5	10	10	0
t12	1	4	6	3	2	5	40	40	0
t13	1	4	6	3	2	5	140	140	0
t21	1	4	6	3	2	5	32	32	0
t22	1	4	6	3	5	2	72	72	0
t23	1	4	6	3	5	2	26	25	1
t11	1	4	6	3	5	2	10	10	0
t12	1	4	6	3	5	2	41	30	11
t13	1	4	6	3	5	2	157	152	5
t21	1	4	6	3	5	2	33	28	5
t22	1	4	6	5	2	3	47	40	7
t23	1	4	6	5	2	3	64	45	19
t11	1	4	6	5	2	3	10	10	0
t12	1	4	6	5	2	3	100	46	54
t13	1	4	6	5	2	3	259	189	70
t21	1	4	6	5	2	3	131	93	38
t22	1	4	6	5	3	2	72	45	27
t23	1	4	6	5	3	2	27	26	1
t11	1	4	6	5	3	2	10	10	0
t12	1	4	6	5	3	2	105	46	59
t13	1	4	6	5	3	2	275	189	86
t21	1	4	6	5	3	2	146	93	53
t22	1	5	2	3	4	6	0	46	-46
t23	1	5	2	3	4	6	0	320	-320
t11	1	5	2	3	4	6	0	10	-10
t12	1	5	2	3	4	6	0	66	-66
t13	1	5	2	3	4	6	0	40	-40
t21	1	5	2	3	4	6	0	27	-27
t22	1	5	2	3	6	4	0	198	-198
t23	1	5	2	3	6	4	0	44	-44
t11	1	5	2	3	6	4	0	10	-10
t12	1	5	2	3	6	4	0	48	-48
t13	1	5	2	3	6	4	0	40	-40
t21	1	5	2	3	6	4	0	27	-27
t22	1	5	2	4	3	6	0	33	-33
t23	1	5	2	4	3	6	0	326	-326
t11	1	5	2	4	3	6	0	10	-10
t12	1	5	2	4	3	6	0	81	-81
t13	1	5	2	4	3	6	0	42	-42
t21	1	5	2	4	3	6	0	46	-46
t22	1	5	2	4	6	3	0	203	-203
t23	1	5	2	4	6	3	0	41	-41
t11	1	5	2	4	6	3	0	10	-10
t12	1	5	2	4	6	3	0	48	-48
t13	1	5	2	4	6	3	0	40	-40
t21	1	5	2	4	6	3	0	32	-32
t22	1	5	2	6	3	4	0	69	-69
t23	1	5	2	6	3	4	0	60	-60
t11	1	5	2	6	3	4	0	10	-10
t12	1	5	2	6	3	4	0	64	-64
t13	1	5	2	6	3	4	0	40	-40
t21	1	5	2	6	3	4	0	213	-213
t22	1	5	2	6	4	3	0	84	-84
t23	1	5	2	6	4	3	0	41	-41
t11	1	5	2	6	4	3	0	10	-10
t12	1	5	2	6	4	3	0	64	-64
t13	1	5	2	6	4	3	0	40	-40
t21	1	5	2	6	4	3	0	213	-213
t22	1	5	3	2	4	6	0	46	-46
t23	1	5	3	2	4	6	0	306	-306
t11	1	5	3	2	4	6	0	10	-10
t12	1	5	3	2	4	6	0	66	-66
t13	1	5	3	2	4	6	0	43	-43
t21	1	5	3	2	4	6	0	13	-13
t22	1	5	3	2	6	4	0	184	-184
t23	1	5	3	2	6	4	0	43	-43
t11	1	5	3	2	6	4	0	10	-10
t12	1	5	3	2	6	4	0	48	-48
t13	1	5	3	2	6	4	0	43	-43
t21	1	5	3	2	6	4	0	13	-13
t22	1	5	3	4	2	6	0	29	-29
t23	1	5	3	4	2	6	0	322	-322
t11	1	5	3	4	2	6	0	10	-10
t12	1	5	3	4	2	6	0	81	-81
t13	1	5	3	4	2	6	0	61	-61
t21	1	5	3	4	2	6	0	46	-46
t22	1	5	3	4	6	2	0	203	-203
t23	1	5	3	4	6	2	0	27	-27
t11	1	5	3	4	6	2	0	10	-10
t12	1	5	3	4	6	2	0	48	-48
t13	1	5	3	4	6	2	0	45	-45
t21	1	5	3	4	6	2	0	32	-32
t22	1	5	3	6	2	4	0	65	-65
t23	1	5	3	6	2	4	0	60	-60
t11	1	5	3	6	2	4	0	10	-10
t12	1	5	3	6	2	4	0	64	-64
t13	1	5	3	6	2	4	0	55	-55
t21	1	5	3	6	2	4	0	213	-213
t22	1	5	3	6	4	2	0	84	-84
t23	1	5	3	6	4	2	0	27	-27
t11	1	5	3	6	4	2	0	10	-10
t12	1	5	3	6	4	2	0	64	-64
t13	1	5	3	6	4	2	0	45	-45
t21	1	5	3	6	4	2	0	213	-213
t22	1	5	4	2	3	6	0	32	-32
t23	1	5	4	2	3	6	0	292	-292
t11	1	5	4	2	3	6	0	10	-10
t12	1	5	4	2	3	6	0	66	-66
t13	1	5	4	2	3	6	0	62	-62
t21	1	5	4	2	3	6	0	13	-13
t22	1	5	4	2	6	3	0	184	-184
t23	1	5	4	2	6	3	0	31	-31
t11	1	5	4	2	6	3	0	10	-10
t12	1	5	4	2	6	3	0	48	-48
t13	1	5	4	2	6	3	0	48	-48
t21	1	5	4	2	6	3	0	13	-13
t22	1	5	4	3	2	6	0	29	-29
t23	1	5	4	3	2	6	0	308	-308
t11	1	5	4	3	2	6	0	10	-10
t12	1	5	4	3	2	6	0	67	-67
t13	1	5	4	3	2	6	0	76	-76
t21	1	5	4	3	2	6	0	32	-32
t22	1	5	4	3	6	2	0	199	-199
t23	1	5	4	3	6	2	0	27	-27
t11	1	5	4	3	6	2	0	10	-10
t12	1	5	4	3	6	2	0	48	-48
t13	1	5	4	3	6	2	0	48	-48
t21	1	5	4	3	6	2	0	28	-28
t22	1	5	4	6	2	3	0	65	-65
t23	1	5	4	6	2	3	0	46	-46
t11	1	5	4	6	2	3	0	10	-10
t12	1	5	4	6	2	3	0	64	-64
t13	1	5	4	6	2	3	0	64	-64
t21	1	5	4	6	2	3	0	213	-213
t22	1	5	4	6	3	2	0	70	-70
t23	1	5	4	6	3	2	0	27	-27
t11	1	5	4	6	3	2	0	10	-10
t12	1	5	4	6	3	2	0	64	-64
t13	1	5	4	6	3	2	0	64	-64
t21	1	5	4	6	3	2	0	213	-213
t22	1	5	6	2	3	4	32	32	0
t23	1	5	6	2	3	4	47	47	0
t11	1	5	6	2	3	4	10	10	0
t12	1	5	6	2	3	4	49	49	0
t13	1	5	6	2	3	4	154	154	0
t21	1	5	6	2	3	4	13	13	0
t22	1	5	6	2	4	3	52	52	0
t23	1	5	6	2	4	3	28	28	0
t11	1	5	6	2	4	3	10	10	0
t12	1	5	6	2	4	3	60	60	0
t13	1	5	6	2	4	3	159	159	0
t21	1	5	6	2	4	3	13	13	0
t22	1	5	6	3	2	4	29	29	0
t23	1	5	6	3	2	4	47	47	0
t11	1	5	6	3	2	4	10	10	0
t12	1	5	6	3	2	4	60	60	0
t13	1	5	6	3	2	4	160	160	0
t21	1	5	6	3	2	4	32	32	0
t22	1	5	6	3	4	2	52	52	0
t23	1	5	6	3	4	2	15	15	0
t11	1	5	6	3	4	2	10	10	0
t12	1	5	6	3	4	2	60	60	0
t13	1	5	6	3	4	2	176	160	16
t21	1	5	6	3	4	2	33	28	5
t22	1	5	6	4	2	3	29	29	0
t23	1	5	6	4	2	3	63	44	19
t11	1	5	6	4	2	3	10	10	0
t12	1	5	6	4	2	3	73	73	0
t13	1	5	6	4	2	3	200	200	0
t21	1	5	6	4	2	3	71	71	0
t22	1	5	6	4	3	2	49	34	15
t23	1	5	6	4	3	2	26	26	0
t11	1	5	6	4	3	2	10	10	0
t12	1	5	6	4	3	2	73	73	0
t13	1	5	6	4	3	2	200	200	0
t21	1	5	6	4	3	2	71	71	0
t22	1	6	2	3	4	5	0	46	-46
t23	1	6	2	3	4	5	0	51	-51
t11	1	6	2	3	4	5	0	10	-10
t12	1	6	2	3	4	5	0	104	-104
t13	1	6	2	3	4	5	0	50	-50
t21	1	6	2	3	4	5	0	27	-27
t22	1	6	2	3	5	4	0	66	-66
t23	1	6	2	3	5	4	0	35	-35
t11	1	6	2	3	5	4	0	10	-10
t12	1	6	2	3	5	4	0	105	-105
t13	1	6	2	3	5	4	0	51	-51
t21	1	6	2	3	5	4	0	27	-27
t22	1	6	2	4	3	5	0	33	-33
t23	1	6	2	4	3	5	0	51	-51
t11	1	6	2	4	3	5	0	10	-10
t12	1	6	2	4	3	5	0	104	-104
t13	1	6	2	4	3	5	0	51	-51
t21	1	6	2	4	3	5	0	46	-46
t22	1	6	2	4	5	3	0	66	-66
t23	1	6	2	4	5	3	0	29	-29
t11	1	6	2	4	5	3	0	10	-10
t12	1	6	2	4	5	3	0	109	-109
t13	1	6	2	4	5	3	0	55	-55
t21	1	6	2	4	5	3	0	32	-32
t22	1	6	2	5	3	4	0	33	-33
t23	1	6	2	5	3	4	0	49	-49
t11	1	6	2	5	3	4	0	10	-10
t12	1	6	2	5	3	4	0	124	-124
t13	1	6	2	5	3	4	0	56	-56
t21	1	6	2	5	3	4	0	75	-75
t22	1	6	2	5	4	3	0	48	-48
t23	1	6	2	5	4	3	0	30	-30
t11	1	6	2	5	4	3	0	10	-10
t12	1	6	2	5	4	3	0	124	-124
t13	1	6	2	5	4	3	0	56	-56
t21	1	6	2	5	4	3	0	75	-75
t22	1	6	3	2	4	5	0	46	-46
t23	1	6	3	2	4	5	0	51	-51
t11	1	6	3	2	4	5	0	10	-10
t12	1	6	3	2	4	5	0	100	-100
t13	1	6	3	2	4	5	0	57	-57
t21	1	6	3	2	4	5	0	13	-13
t22	1	6	3	2	5	4	0	66	-66
t23	1	6	3	2	5	4	0	32	-32
t11	1	6	3	2	5	4	0	10	-10
t12	1	6	3	2	5	4	0	101	-101
t13	1	6	3	2	5	4	0	57	-57
t21	1	6	3	2	5	4	0	13	-13
t22	1	6	3	4	2	5	0	29	-29
t23	1	6	3	4	2	5	0	51	-51
t11	1	6	3	4	2	5	0	10	-10
t12	1	6	3	4	2	5	0	104	-104
t13	1	6	3	4	2	5	0	70	-70
t21	1	6	3	4	2	5	0	46	-46
t22	1	6	3	4	5	2	0	66	-66
t23	1	6	3	4	5	2	0	23	-23
t11	1	6	3	4	5	2	0	10	-10
t12	1	6	3	4	5	2	0	109	-109
t13	1	6	3	4	5	2	0	60	-60
t21	1	6	3	4	5	2	0	32	-32
t22	1	6	3	5	2	4	0	29	-29
t23	1	6	3	5	2	4	0	49	-49
t11	1	6	3	5	2	4	0	10	-10
t12	1	6	3	5	2	4	0	124	-124
t13	1	6	3	5	2	4	0	75	-75
t21	1	6	3	5	2	4	0	75	-75
t22	1	6	3	5	4	2	0	48	-48
t23	1	6	3	5	4	2	0	26	-26
t11	1	6	3	5	4	2	0	10	-10
t12	1	6	3	5	4	2	0	124	-124
t13	1	6	3	5	4	2	0	69	-69
t21	1	6	3	5	4	2	0	75	-75
t22	1	6	4	2	3	5	0	32	-32
t23	1	6	4	2	3	5	0	51	-51
t11	1	6	4	2	3	5	0	10	-10
t12	1	6	4	2	3	5	0	100	-100
t13	1	6	4	2	3	5	0	90	-90
t21	1	6	4	2	3	5	0	13	-13
t22	1	6	4	2	5	3	0	66	-66
t23	1	6	4	2	5	3	0	28	-28
t11	1	6	4	2	5	3	0	10	-10
t12	1	6	4	2	5	3	0	101	-101
t13	1	6	4	2	5	3	0	65	-65
t21	1	6	4	2	5	3	0	13	-13
t22	1	6	4	3	2	5	0	29	-29
t23	1	6	4	3	2	5	0	51	-51
t11	1	6	4	3	2	5	0	10	-10
t12	1	6	4	3	2	5	0	104	-104
t13	1	6	4	3	2	5	0	95	-95
t21	1	6	4	3	2	5	0	32	-32
t22	1	6	4	3	5	2	0	66	-66
t23	1	6	4	3	5	2	0	19	-19
t11	1	6	4	3	5	2	0	10	-10
t12	1	6	4	3	5	2	0	105	-105
t13	1	6	4	3	5	2	0	69	-69
t21	1	6	4	3	5	2	0	28	-28
t22	1	6	4	5	2	3	0	29	-29
t23	1	6	4	5	2	3	0	45	-45
t11	1	6	4	5	2	3	0	10	-10
t12	1	6	4	5	2	3	0	124	-124
t13	1	6	4	5	2	3	0	88	-88
t21	1	6	4	5	2	3	0	75	-75
t22	1	6	4	5	3	2	0	34	-34
t23	1	6	4	5	3	2	0	26	-26
t11	1	6	4	5	3	2	0	10	-10
t12	1	6	4	5	3	2	0	124	-124
t13	1	6	4	5	3	2	0	88	-88
t21	1	6	4	5	3	2	0	75	-75
t22	1	6	5	2	3	4	0	32	-32
t23	1	6	5	2	3	4	0	47	-47
t11	1	6	5	2	3	4	0	10	-10
t12	1	6	5	2	3	4	0	100	-100
t13	1	6	5	2	3	4	0	118	-118
t21	1	6	5	2	3	4	0	13	-13
t22	1	6	5	2	4	3	0	52	-52
t23	1	6	5	2	4	3	0	28	-28
t11	1	6	5	2	4	3	0	10	-10
t12	1	6	5	2	4	3	0	100	-100
t13	1	6	5	2	4	3	0	118	-118
t21	1	6	5	2	4	3	0	13	-13
t22	1	6	5	3	2	4	0	29	-29
t23	1	6	5	3	2	4	0	47	-47
t11	1	6	5	3	2	4	0	10	-10
t12	1	6	5	3	2	4	0	104	-104
t13	1	6	5	3	2	4	0	118	-118
t21	1	6	5	3	2	4	0	32	-32
t22	1	6	5	3	4	2	0	52	-52
t23	1	6	5	3	4	2	0	15	-15
t11	1	6	5	3	4	2	0	10	-10
t12	1	6	5	3	4	2	0	105	-105
t13	1	6	5	3	4	2	0	130	-130
t21	1	6	5	3	4	2	0	28	-28
t22	1	6	5	4	2	3	0	29	-29
t23	1	6	5	4	2	3	0	44	-44
t11	1	6	5	4	2	3	0	10	-10
t12	1	6	5	4	2	3	0	124	-124
t13	1	6	5	4	2	3	0	154	-154
t21	1	6	5	4	2	3	0	71	-71
t22	1	6	5	4	3	2	0	34	-34
t23	1	6	5	4	3	2	0	26	-26
t11	1	6	5	4	3	2	0	10	-10
t12	1	6	5	4	3	2	0	124	-124
t13	1	6	5	4	3	2	0	154	-154
t21	1	6	5	4	3	2	0	71	-71
t22	2	1	3	4	5	6	146	146	0
t23	2	1	3	4	5	6	466	466	0
t11	2	1	3	4	5	6	14	14	0
t12	2	1	3	4	5	6	2	2	0
t13	2	1	3	4	5	6	32	32	0
t21	2	1	3	4	5	6	73	73	0
t22	2	1	3	4	6	5	424	244	180
t23	2	1	3	4	6	5	216	147	69
t11	2	1	3	4	6	5	14	14	0
t12	2	1	3	4	6	5	2	2	0
t13	2	1	3	4	6	5	32	32	0
t21	2	1	3	4	6	5	73	73	0
t22	2	1	3	5	4	6	407	151	256
t23	2	1	3	5	4	6	1462	466	996
t11	2	1	3	5	4	6	14	14	0
t12	2	1	3	5	4	6	2	2	0
t13	2	1	3	5	4	6	32	32	0
t21	2	1	3	5	4	6	695	155	540
t22	2	1	3	5	6	4	1007	265	742
t23	2	1	3	5	6	4	310	125	185
t11	2	1	3	5	6	4	14	14	0
t12	2	1	3	5	6	4	2	2	0
t13	2	1	3	5	6	4	32	32	0
t21	2	1	3	5	6	4	473	94	379
t22	2	1	3	6	4	5	0	191	-191
t23	2	1	3	6	4	5	0	183	-183
t11	2	1	3	6	4	5	0	14	-14
t12	2	1	3	6	4	5	0	2	-2
t13	2	1	3	6	4	5	0	32	-32
t21	2	1	3	6	4	5	0	213	-213
t22	2	1	3	6	5	4	0	212	-212
t23	2	1	3	6	5	4	0	142	-142
t11	2	1	3	6	5	4	0	14	-14
t12	2	1	3	6	5	4	0	2	-2
t13	2	1	3	6	5	4	0	32	-32
t21	2	1	3	6	5	4	0	213	-213
t22	2	1	4	3	5	6	133	133	0
t23	2	1	4	3	5	6	390	390	0
t11	2	1	4	3	5	6	14	14	0
t12	2	1	4	3	5	6	2	2	0
t13	2	1	4	3	5	6	47	47	0
t21	2	1	4	3	5	6	29	29	0
t22	2	1	4	3	6	5	343	200	143
t23	2	1	4	3	6	5	190	147	43
t11	2	1	4	3	6	5	14	14	0
t12	2	1	4	3	6	5	2	2	0
t13	2	1	4	3	6	5	47	47	0
t21	2	1	4	3	6	5	29	29	0
t22	2	1	4	5	3	6	187	67	120
t23	2	1	4	5	3	6	1445	459	986
t11	2	1	4	5	3	6	14	14	0
t12	2	1	4	5	3	6	2	2	0
t13	2	1	4	5	3	6	266	53	213
t21	2	1	4	5	3	6	695	155	540
t22	2	1	4	5	6	3	1007	265	742
t23	2	1	4	5	6	3	126	45	81
t11	2	1	4	5	6	3	14	14	0
t12	2	1	4	5	6	3	2	2	0
t13	2	1	4	5	6	3	210	49	161
t21	2	1	4	5	6	3	473	94	379
t22	2	1	4	6	3	5	0	87	-87
t23	2	1	4	6	3	5	0	166	-166
t11	2	1	4	6	3	5	0	14	-14
t12	2	1	4	6	3	5	0	2	-2
t13	2	1	4	6	3	5	0	53	-53
t21	2	1	4	6	3	5	0	213	-213
t22	2	1	4	6	5	3	0	212	-212
t23	2	1	4	6	5	3	0	58	-58
t11	2	1	4	6	5	3	0	14	-14
t12	2	1	4	6	5	3	0	2	-2
t13	2	1	4	6	5	3	0	49	-49
t21	2	1	4	6	5	3	0	213	-213
t22	2	1	5	3	4	6	50	50	0
t23	2	1	5	3	4	6	326	326	0
t11	2	1	5	3	4	6	14	14	0
t12	2	1	5	3	4	6	2	2	0
t13	2	1	5	3	4	6	73	73	0
t21	2	1	5	3	4	6	29	29	0
t22	2	1	5	3	6	4	343	200	143
t23	2	1	5	3	6	4	61	60	1
t11	2	1	5	3	6	4	14	14	0
t12	2	1	5	3	6	4	2	2	0
t13	2	1	5	3	6	4	111	52	59
t21	2	1	5	3	6	4	29	29	0
t22	2	1	5	4	3	6	35	35	0
t23	2	1	5	4	3	6	373	373	0
t11	2	1	5	4	3	6	14	14	0
t12	2	1	5	4	3	6	2	2	0
t13	2	1	5	4	3	6	89	89	0
t21	2	1	5	4	3	6	50	50	0
t22	2	1	5	4	6	3	446	205	241
t23	2	1	5	4	6	3	59	45	14
t11	2	1	5	4	6	3	14	14	0
t12	2	1	5	4	6	3	2	2	0
t13	2	1	5	4	6	3	128	52	76
t21	2	1	5	4	6	3	95	34	61
t22	2	1	5	6	3	4	0	87	-87
t23	2	1	5	6	3	4	0	66	-66
t11	2	1	5	6	3	4	0	14	-14
t12	2	1	5	6	3	4	0	2	-2
t13	2	1	5	6	3	4	0	70	-70
t21	2	1	5	6	3	4	0	213	-213
t22	2	1	5	6	4	3	0	92	-92
t23	2	1	5	6	4	3	0	45	-45
t11	2	1	5	6	4	3	0	14	-14
t12	2	1	5	6	4	3	0	2	-2
t13	2	1	5	6	4	3	0	70	-70
t21	2	1	5	6	4	3	0	213	-213
t22	2	1	6	3	4	5	50	50	0
t23	2	1	6	3	4	5	55	55	0
t11	2	1	6	3	4	5	14	14	0
t12	2	1	6	3	4	5	2	2	0
t13	2	1	6	3	4	5	131	131	0
t21	2	1	6	3	4	5	29	29	0
t22	2	1	6	3	5	4	72	72	0
t23	2	1	6	3	5	4	47	47	0
t11	2	1	6	3	5	4	14	14	0
t12	2	1	6	3	5	4	2	2	0
t13	2	1	6	3	5	4	131	131	0
t21	2	1	6	3	5	4	29	29	0
t22	2	1	6	4	3	5	35	35	0
t23	2	1	6	4	3	5	88	88	0
t11	2	1	6	4	3	5	14	14	0
t12	2	1	6	4	3	5	2	2	0
t13	2	1	6	4	3	5	132	132	0
t21	2	1	6	4	3	5	50	50	0
t22	2	1	6	4	5	3	72	72	0
t23	2	1	6	4	5	3	44	44	0
t11	2	1	6	4	5	3	14	14	0
t12	2	1	6	4	5	3	2	2	0
t13	2	1	6	4	5	3	133	131	2
t21	2	1	6	4	5	3	51	34	17
t22	2	1	6	5	3	4	67	60	7
t23	2	1	6	5	3	4	107	65	42
t11	2	1	6	5	3	4	14	14	0
t12	2	1	6	5	3	4	2	2	0
t13	2	1	6	5	3	4	190	152	38
t21	2	1	6	5	3	4	131	93	38
t22	2	1	6	5	4	3	111	65	46
t23	2	1	6	5	4	3	45	44	1
t11	2	1	6	5	4	3	14	14	0
t12	2	1	6	5	4	3	2	2	0
t13	2	1	6	5	4	3	210	152	58
t21	2	1	6	5	4	3	148	93	55
t22	2	3	1	4	5	6	863	146	717
t23	2	3	1	4	5	6	2474	466	2008
t11	2	3	1	4	5	6	110	14	96
t12	2	3	1	4	5	6	308	44	264
t13	2	3	1	4	5	6	46	8	38
t21	2	3	1	4	5	6	491	73	418
t22	2	3	1	4	6	5	2223	244	1979
t23	2	3	1	4	6	5	1196	147	1049
t11	2	3	1	4	6	5	110	14	96
t12	2	3	1	4	6	5	308	44	264
t13	2	3	1	4	6	5	46	8	38
t21	2	3	1	4	6	5	491	73	418
t22	2	3	1	5	4	6	2665	151	2514
t23	2	3	1	5	4	6	10072	466	9606
t11	2	3	1	5	4	6	110	14	96
t12	2	3	1	5	4	6	308	44	264
t13	2	3	1	5	4	6	46	8	38
t21	2	3	1	5	4	6	4893	155	4738
t22	2	3	1	5	6	4	5385	265	5120
t23	2	3	1	5	6	4	1803	125	1678
t11	2	3	1	5	6	4	110	14	96
t12	2	3	1	5	6	4	308	44	264
t13	2	3	1	5	6	4	46	8	38
t21	2	3	1	5	6	4	2654	94	2560
t22	2	3	1	6	4	5	0	191	-191
t23	2	3	1	6	4	5	0	183	-183
t11	2	3	1	6	4	5	0	14	-14
t12	2	3	1	6	4	5	0	44	-44
t13	2	3	1	6	4	5	0	8	-8
t21	2	3	1	6	4	5	0	213	-213
t22	2	3	1	6	5	4	0	212	-212
t23	2	3	1	6	5	4	0	142	-142
t11	2	3	1	6	5	4	0	14	-14
t12	2	3	1	6	5	4	0	44	-44
t13	2	3	1	6	5	4	0	8	-8
t21	2	3	1	6	5	4	0	213	-213
t22	2	3	4	1	5	6	149	133	16
t23	2	3	4	1	5	6	364	304	60
t11	2	3	4	1	5	6	13	13	0
t12	2	3	4	1	5	6	24	24	0
t13	2	3	4	1	5	6	47	47	0
t21	2	3	4	1	5	6	3	3	0
t22	2	3	4	1	6	5	350	175	175
t23	2	3	4	1	6	5	203	130	73
t11	2	3	4	1	6	5	13	13	0
t12	2	3	4	1	6	5	24	24	0
t13	2	3	4	1	6	5	47	47	0
t21	2	3	4	1	6	5	3	3	0
t22	2	3	4	5	1	6	0	17	-17
t23	2	3	4	5	1	6	0	433	-433
t11	2	3	4	5	1	6	0	19	-19
t12	2	3	4	5	1	6	0	32	-32
t13	2	3	4	5	1	6	0	67	-67
t21	2	3	4	5	1	6	0	155	-155
t22	2	3	4	5	6	1	0	265	-265
t23	2	3	4	5	6	1	0	7	-7
t11	2	3	4	5	6	1	0	15	-15
t12	2	3	4	5	6	1	0	28	-28
t13	2	3	4	5	6	1	0	55	-55
t21	2	3	4	5	6	1	0	94	-94
t22	2	3	4	6	1	5	0	25	-25
t23	2	3	4	6	1	5	0	166	-166
t11	2	3	4	6	1	5	0	19	-19
t12	2	3	4	6	1	5	0	32	-32
t13	2	3	4	6	1	5	0	67	-67
t21	2	3	4	6	1	5	0	213	-213
t22	2	3	4	6	5	1	0	212	-212
t23	2	3	4	6	5	1	0	8	-8
t11	2	3	4	6	5	1	0	15	-15
t12	2	3	4	6	5	1	0	28	-28
t13	2	3	4	6	5	1	0	55	-55
t21	2	3	4	6	5	1	0	213	-213
t22	2	3	5	1	4	6	50	50	0
t23	2	3	5	1	4	6	316	240	76
t11	2	3	5	1	4	6	13	13	0
t12	2	3	5	1	4	6	24	24	0
t13	2	3	5	1	4	6	68	68	0
t21	2	3	5	1	4	6	3	3	0
t22	2	3	5	1	6	4	350	175	175
t23	2	3	5	1	6	4	61	47	14
t11	2	3	5	1	6	4	13	13	0
t12	2	3	5	1	6	4	24	24	0
t13	2	3	5	1	6	4	119	60	59
t21	2	3	5	1	6	4	3	3	0
t22	2	3	5	4	1	6	9	9	0
t23	2	3	5	4	1	6	415	347	68
t11	2	3	5	4	1	6	19	19	0
t12	2	3	5	4	1	6	32	32	0
t13	2	3	5	4	1	6	106	106	0
t21	2	3	5	4	1	6	50	50	0
t22	2	3	5	4	6	1	2127	205	1922
t23	2	3	5	4	6	1	28	7	21
t11	2	3	5	4	6	1	130	15	115
t12	2	3	5	4	6	1	299	28	271
t13	2	3	5	4	6	1	668	66	602
t21	2	3	5	4	6	1	375	34	341
t22	2	3	5	6	1	4	0	25	-25
t23	2	3	5	6	1	4	0	66	-66
t11	2	3	5	6	1	4	0	19	-19
t12	2	3	5	6	1	4	0	32	-32
t13	2	3	5	6	1	4	0	84	-84
t21	2	3	5	6	1	4	0	213	-213
t22	2	3	5	6	4	1	0	92	-92
t23	2	3	5	6	4	1	0	7	-7
t11	2	3	5	6	4	1	0	15	-15
t12	2	3	5	6	4	1	0	28	-28
t13	2	3	5	6	4	1	0	84	-84
t21	2	3	5	6	4	1	0	213	-213
t22	2	3	6	1	4	5	50	50	0
t23	2	3	6	1	4	5	55	55	0
t11	2	3	6	1	4	5	13	13	0
t12	2	3	6	1	4	5	24	24	0
t13	2	3	6	1	4	5	122	122	0
t21	2	3	6	1	4	5	3	3	0
t22	2	3	6	1	5	4	72	72	0
t23	2	3	6	1	5	4	34	34	0
t11	2	3	6	1	5	4	13	13	0
t12	2	3	6	1	5	4	24	24	0
t13	2	3	6	1	5	4	139	139	0
t21	2	3	6	1	5	4	3	3	0
t22	2	3	6	4	1	5	9	9	0
t23	2	3	6	4	1	5	88	88	0
t11	2	3	6	4	1	5	19	19	0
t12	2	3	6	4	1	5	32	32	0
t13	2	3	6	4	1	5	166	166	0
t21	2	3	6	4	1	5	50	50	0
t22	2	3	6	4	5	1	72	72	0
t23	2	3	6	4	5	1	6	6	0
t11	2	3	6	4	5	1	20	15	5
t12	2	3	6	4	5	1	33	28	5
t13	2	3	6	4	5	1	169	154	15
t21	2	3	6	4	5	1	51	34	17
t22	2	3	6	5	1	4	12	10	2
t23	2	3	6	5	1	4	88	65	23
t11	2	3	6	5	1	4	28	19	9
t12	2	3	6	5	1	4	51	32	19
t13	2	3	6	5	1	4	227	183	44
t21	2	3	6	5	1	4	95	93	2
t22	2	3	6	5	4	1	113	65	48
t23	2	3	6	5	4	1	7	6	1
t11	2	3	6	5	4	1	25	15	10
t12	2	3	6	5	4	1	48	28	20
t13	2	3	6	5	4	1	264	175	89
t21	2	3	6	5	4	1	148	93	55
t22	2	4	1	3	5	6	6362	133	6229
t23	2	4	1	3	5	6	18211	348	17863
t11	2	4	1	3	5	6	950	14	936
t12	2	4	1	3	5	6	3122	47	3075
t13	2	4	1	3	5	6	420	8	412
t21	2	4	1	3	5	6	2529	27	2502
t22	2	4	1	3	6	5	16002	198	15804
t23	2	4	1	3	6	5	9440	147	9293
t11	2	4	1	3	6	5	950	14	936
t12	2	4	1	3	6	5	3122	47	3075
t13	2	4	1	3	6	5	420	8	412
t21	2	4	1	3	6	5	2529	27	2502
t22	2	4	1	5	3	6	0	51	-51
t23	2	4	1	5	3	6	0	457	-457
t11	2	4	1	5	3	6	0	14	-14
t12	2	4	1	5	3	6	0	53	-53
t13	2	4	1	5	3	6	0	10	-10
t21	2	4	1	5	3	6	0	155	-155
t22	2	4	1	5	6	3	0	265	-265
t23	2	4	1	5	6	3	0	41	-41
t11	2	4	1	5	6	3	0	14	-14
t12	2	4	1	5	6	3	0	49	-49
t13	2	4	1	5	6	3	0	8	-8
t21	2	4	1	5	6	3	0	94	-94
t22	2	4	1	6	3	5	0	69	-69
t23	2	4	1	6	3	5	0	166	-166
t11	2	4	1	6	3	5	0	14	-14
t12	2	4	1	6	3	5	0	53	-53
t13	2	4	1	6	3	5	0	10	-10
t21	2	4	1	6	3	5	0	213	-213
t22	2	4	1	6	5	3	0	212	-212
t23	2	4	1	6	5	3	0	42	-42
t11	2	4	1	6	5	3	0	14	-14
t12	2	4	1	6	5	3	0	49	-49
t13	2	4	1	6	5	3	0	8	-8
t21	2	4	1	6	5	3	0	213	-213
t22	2	4	3	1	5	6	292	133	159
t23	2	4	3	1	5	6	778	304	474
t11	2	4	3	1	5	6	13	13	0
t12	2	4	3	1	5	6	165	46	119
t13	2	4	3	1	5	6	77	37	40
t21	2	4	3	1	5	6	3	3	0
t22	2	4	3	1	6	5	750	175	575
t23	2	4	3	1	6	5	461	130	331
t11	2	4	3	1	6	5	13	13	0
t12	2	4	3	1	6	5	165	46	119
t13	2	4	3	1	6	5	77	37	40
t21	2	4	3	1	6	5	3	3	0
t22	2	4	3	5	1	6	0	17	-17
t23	2	4	3	5	1	6	0	433	-433
t11	2	4	3	5	1	6	0	19	-19
t12	2	4	3	5	1	6	0	54	-54
t13	2	4	3	5	1	6	0	59	-59
t21	2	4	3	5	1	6	0	155	-155
t22	2	4	3	5	6	1	0	265	-265
t23	2	4	3	5	6	1	0	7	-7
t11	2	4	3	5	6	1	0	15	-15
t12	2	4	3	5	6	1	0	50	-50
t13	2	4	3	5	6	1	0	43	-43
t21	2	4	3	5	6	1	0	94	-94
t22	2	4	3	6	1	5	0	25	-25
t23	2	4	3	6	1	5	0	166	-166
t11	2	4	3	6	1	5	0	19	-19
t12	2	4	3	6	1	5	0	54	-54
t13	2	4	3	6	1	5	0	59	-59
t21	2	4	3	6	1	5	0	213	-213
t22	2	4	3	6	5	1	0	212	-212
t23	2	4	3	6	5	1	0	8	-8
t11	2	4	3	6	5	1	0	15	-15
t12	2	4	3	6	5	1	0	50	-50
t13	2	4	3	6	5	1	0	43	-43
t21	2	4	3	6	5	1	0	213	-213
t22	2	4	5	1	3	6	32	32	0
t23	2	4	5	1	3	6	318	222	96
t11	2	4	5	1	3	6	13	13	0
t12	2	4	5	1	3	6	43	43	0
t13	2	4	5	1	3	6	83	83	0
t21	2	4	5	1	3	6	3	3	0
t22	2	4	5	1	6	3	573	175	398
t23	2	4	5	1	6	3	59	29	30
t11	2	4	5	1	6	3	13	13	0
t12	2	4	5	1	6	3	90	30	60
t13	2	4	5	1	6	3	196	66	130
t21	2	4	5	1	6	3	3	3	0
t22	2	4	5	3	1	6	9	9	0
t23	2	4	5	3	1	6	388	288	100
t11	2	4	5	3	1	6	19	19	0
t12	2	4	5	3	1	6	45	45	0
t13	2	4	5	3	1	6	108	108	0
t21	2	4	5	3	1	6	32	32	0
t22	2	4	5	3	6	1	1459	199	1260
t23	2	4	5	3	6	1	20	7	13
t11	2	4	5	3	6	1	90	15	75
t12	2	4	5	3	6	1	225	31	194
t13	2	4	5	3	6	1	459	66	393
t21	2	4	5	3	6	1	188	28	160
t22	2	4	5	6	1	3	0	25	-25
t23	2	4	5	6	1	3	0	46	-46
t11	2	4	5	6	1	3	0	19	-19
t12	2	4	5	6	1	3	0	47	-47
t13	2	4	5	6	1	3	0	95	-95
t21	2	4	5	6	1	3	0	213	-213
t22	2	4	5	6	3	1	0	70	-70
t23	2	4	5	6	3	1	0	7	-7
t11	2	4	5	6	3	1	0	15	-15
t12	2	4	5	6	3	1	0	47	-47
t13	2	4	5	6	3	1	0	91	-91
t21	2	4	5	6	3	1	0	213	-213
t22	2	4	6	1	3	5	32	32	0
t23	2	4	6	1	3	5	55	55	0
t11	2	4	6	1	3	5	13	13	0
t12	2	4	6	1	3	5	43	43	0
t13	2	4	6	1	3	5	137	137	0
t21	2	4	6	1	3	5	3	3	0
t22	2	4	6	1	5	3	72	72	0
t23	2	4	6	1	5	3	28	28	0
t11	2	4	6	1	5	3	13	13	0
t12	2	4	6	1	5	3	44	30	14
t13	2	4	6	1	5	3	145	145	0
t21	2	4	6	1	5	3	3	3	0
t22	2	4	6	3	1	5	9	9	0
t23	2	4	6	3	1	5	55	55	0
t11	2	4	6	3	1	5	19	19	0
t12	2	4	6	3	1	5	45	45	0
t13	2	4	6	3	1	5	149	149	0
t21	2	4	6	3	1	5	32	32	0
t22	2	4	6	3	5	1	72	72	0
t23	2	4	6	3	5	1	6	5	1
t11	2	4	6	3	5	1	20	15	5
t12	2	4	6	3	5	1	46	31	15
t13	2	4	6	3	5	1	167	157	10
t21	2	4	6	3	5	1	33	28	5
t22	2	4	6	5	1	3	12	10	2
t23	2	4	6	5	1	3	64	45	19
t11	2	4	6	5	1	3	28	19	9
t12	2	4	6	5	1	3	71	47	24
t13	2	4	6	5	1	3	237	198	39
t21	2	4	6	5	1	3	95	93	2
t22	2	4	6	5	3	1	72	45	27
t23	2	4	6	5	3	1	7	6	1
t11	2	4	6	5	3	1	25	15	10
t12	2	4	6	5	3	1	110	47	63
t13	2	4	6	5	3	1	290	194	96
t21	2	4	6	5	3	1	148	93	55
t22	2	5	1	3	4	6	0	46	-46
t23	2	5	1	3	4	6	0	320	-320
t11	2	5	1	3	4	6	0	14	-14
t12	2	5	1	3	4	6	0	70	-70
t13	2	5	1	3	4	6	0	10	-10
t21	2	5	1	3	4	6	0	27	-27
t22	2	5	1	3	6	4	0	198	-198
t23	2	5	1	3	6	4	0	44	-44
t11	2	5	1	3	6	4	0	14	-14
t12	2	5	1	3	6	4	0	52	-52
t13	2	5	1	3	6	4	0	10	-10
t21	2	5	1	3	6	4	0	27	-27
t22	2	5	1	4	3	6	0	33	-33
t23	2	5	1	4	3	6	0	326	-326
t11	2	5	1	4	3	6	0	14	-14
t12	2	5	1	4	3	6	0	85	-85
t13	2	5	1	4	3	6	0	12	-12
t21	2	5	1	4	3	6	0	46	-46
t22	2	5	1	4	6	3	0	203	-203
t23	2	5	1	4	6	3	0	41	-41
t11	2	5	1	4	6	3	0	14	-14
t12	2	5	1	4	6	3	0	52	-52
t13	2	5	1	4	6	3	0	10	-10
t21	2	5	1	4	6	3	0	32	-32
t22	2	5	1	6	3	4	0	69	-69
t23	2	5	1	6	3	4	0	60	-60
t11	2	5	1	6	3	4	0	14	-14
t12	2	5	1	6	3	4	0	68	-68
t13	2	5	1	6	3	4	0	10	-10
t21	2	5	1	6	3	4	0	213	-213
t22	2	5	1	6	4	3	0	84	-84
t23	2	5	1	6	4	3	0	41	-41
t11	2	5	1	6	4	3	0	14	-14
t12	2	5	1	6	4	3	0	68	-68
t13	2	5	1	6	4	3	0	10	-10
t21	2	5	1	6	4	3	0	213	-213
t22	2	5	3	1	4	6	0	46	-46
t23	2	5	3	1	4	6	0	236	-236
t11	2	5	3	1	4	6	0	13	-13
t12	2	5	3	1	4	6	0	65	-65
t13	2	5	3	1	4	6	0	43	-43
t21	2	5	3	1	4	6	0	3	-3
t22	2	5	3	1	6	4	0	175	-175
t23	2	5	3	1	6	4	0	43	-43
t11	2	5	3	1	6	4	0	13	-13
t12	2	5	3	1	6	4	0	51	-51
t13	2	5	3	1	6	4	0	43	-43
t21	2	5	3	1	6	4	0	3	-3
t22	2	5	3	4	1	6	0	9	-9
t23	2	5	3	4	1	6	0	302	-302
t11	2	5	3	4	1	6	0	19	-19
t12	2	5	3	4	1	6	0	86	-86
t13	2	5	3	4	1	6	0	61	-61
t21	2	5	3	4	1	6	0	46	-46
t22	2	5	3	4	6	1	0	203	-203
t23	2	5	3	4	6	1	0	7	-7
t11	2	5	3	4	6	1	0	15	-15
t12	2	5	3	4	6	1	0	53	-53
t13	2	5	3	4	6	1	0	45	-45
t21	2	5	3	4	6	1	0	32	-32
t22	2	5	3	6	1	4	0	25	-25
t23	2	5	3	6	1	4	0	60	-60
t11	2	5	3	6	1	4	0	19	-19
t12	2	5	3	6	1	4	0	69	-69
t13	2	5	3	6	1	4	0	61	-61
t21	2	5	3	6	1	4	0	213	-213
t22	2	5	3	6	4	1	0	84	-84
t23	2	5	3	6	4	1	0	7	-7
t11	2	5	3	6	4	1	0	15	-15
t12	2	5	3	6	4	1	0	69	-69
t13	2	5	3	6	4	1	0	46	-46
t21	2	5	3	6	4	1	0	213	-213
t22	2	5	4	1	3	6	0	32	-32
t23	2	5	4	1	3	6	0	222	-222
t11	2	5	4	1	3	6	0	13	-13
t12	2	5	4	1	3	6	0	65	-65
t13	2	5	4	1	3	6	0	62	-62
t21	2	5	4	1	3	6	0	3	-3
t22	2	5	4	1	6	3	0	175	-175
t23	2	5	4	1	6	3	0	29	-29
t11	2	5	4	1	6	3	0	13	-13
t12	2	5	4	1	6	3	0	51	-51
t13	2	5	4	1	6	3	0	51	-51
t21	2	5	4	1	6	3	0	3	-3
t22	2	5	4	3	1	6	0	9	-9
t23	2	5	4	3	1	6	0	288	-288
t11	2	5	4	3	1	6	0	19	-19
t12	2	5	4	3	1	6	0	76	-76
t13	2	5	4	3	1	6	0	83	-83
t21	2	5	4	3	1	6	0	32	-32
t22	2	5	4	3	6	1	0	199	-199
t23	2	5	4	3	6	1	0	7	-7
t11	2	5	4	3	6	1	0	15	-15
t12	2	5	4	3	6	1	0	53	-53
t13	2	5	4	3	6	1	0	53	-53
t21	2	5	4	3	6	1	0	28	-28
t22	2	5	4	6	1	3	0	25	-25
t23	2	5	4	6	1	3	0	46	-46
t11	2	5	4	6	1	3	0	19	-19
t12	2	5	4	6	1	3	0	69	-69
t13	2	5	4	6	1	3	0	66	-66
t21	2	5	4	6	1	3	0	213	-213
t22	2	5	4	6	3	1	0	70	-70
t23	2	5	4	6	3	1	0	7	-7
t11	2	5	4	6	3	1	0	15	-15
t12	2	5	4	6	3	1	0	69	-69
t13	2	5	4	6	3	1	0	65	-65
t21	2	5	4	6	3	1	0	213	-213
t22	2	5	6	1	3	4	32	32	0
t23	2	5	6	1	3	4	47	47	0
t11	2	5	6	1	3	4	13	13	0
t12	2	5	6	1	3	4	49	49	0
t13	2	5	6	1	3	4	142	142	0
t21	2	5	6	1	3	4	3	3	0
t22	2	5	6	1	4	3	47	47	0
t23	2	5	6	1	4	3	28	28	0
t11	2	5	6	1	4	3	13	13	0
t12	2	5	6	1	4	3	49	49	0
t13	2	5	6	1	4	3	142	142	0
t21	2	5	6	1	4	3	3	3	0
t22	2	5	6	3	1	4	9	9	0
t23	2	5	6	3	1	4	47	47	0
t11	2	5	6	3	1	4	19	19	0
t12	2	5	6	3	1	4	50	50	0
t13	2	5	6	3	1	4	164	164	0
t21	2	5	6	3	1	4	32	32	0
t22	2	5	6	3	4	1	52	52	0
t23	2	5	6	3	4	1	5	5	0
t11	2	5	6	3	4	1	15	15	0
t12	2	5	6	3	4	1	65	65	0
t13	2	5	6	3	4	1	181	165	16
t21	2	5	6	3	4	1	33	28	5
t22	2	5	6	4	1	3	9	9	0
t23	2	5	6	4	1	3	34	34	0
t11	2	5	6	4	1	3	19	19	0
t12	2	5	6	4	1	3	74	74	0
t13	2	5	6	4	1	3	182	182	0
t21	2	5	6	4	1	3	47	47	0
t22	2	5	6	4	3	1	49	34	15
t23	2	5	6	4	3	1	6	6	0
t11	2	5	6	4	3	1	20	15	5
t12	2	5	6	4	3	1	76	74	2
t13	2	5	6	4	3	1	210	205	5
t21	2	5	6	4	3	1	71	71	0
t22	2	6	1	3	4	5	0	46	-46
t23	2	6	1	3	4	5	0	51	-51
t11	2	6	1	3	4	5	0	14	-14
t12	2	6	1	3	4	5	0	108	-108
t13	2	6	1	3	4	5	0	14	-14
t21	2	6	1	3	4	5	0	27	-27
t22	2	6	1	3	5	4	0	66	-66
t23	2	6	1	3	5	4	0	35	-35
t11	2	6	1	3	5	4	0	14	-14
t12	2	6	1	3	5	4	0	109	-109
t13	2	6	1	3	5	4	0	15	-15
t21	2	6	1	3	5	4	0	27	-27
t22	2	6	1	4	3	5	0	33	-33
t23	2	6	1	4	3	5	0	51	-51
t11	2	6	1	4	3	5	0	14	-14
t12	2	6	1	4	3	5	0	108	-108
t13	2	6	1	4	3	5	0	15	-15
t21	2	6	1	4	3	5	0	46	-46
t22	2	6	1	4	5	3	0	66	-66
t23	2	6	1	4	5	3	0	29	-29
t11	2	6	1	4	5	3	0	14	-14
t12	2	6	1	4	5	3	0	113	-113
t13	2	6	1	4	5	3	0	16	-16
t21	2	6	1	4	5	3	0	32	-32
t22	2	6	1	5	3	4	0	33	-33
t23	2	6	1	5	3	4	0	49	-49
t11	2	6	1	5	3	4	0	14	-14
t12	2	6	1	5	3	4	0	128	-128
t13	2	6	1	5	3	4	0	18	-18
t21	2	6	1	5	3	4	0	75	-75
t22	2	6	1	5	4	3	0	48	-48
t23	2	6	1	5	4	3	0	30	-30
t11	2	6	1	5	4	3	0	14	-14
t12	2	6	1	5	4	3	0	128	-128
t13	2	6	1	5	4	3	0	18	-18
t21	2	6	1	5	4	3	0	75	-75
t22	2	6	3	1	4	5	0	46	-46
t23	2	6	3	1	4	5	0	51	-51
t11	2	6	3	1	4	5	0	13	-13
t12	2	6	3	1	4	5	0	89	-89
t13	2	6	3	1	4	5	0	54	-54
t21	2	6	3	1	4	5	0	3	-3
t22	2	6	3	1	5	4	0	51	-51
t23	2	6	3	1	5	4	0	32	-32
t11	2	6	3	1	5	4	0	13	-13
t12	2	6	3	1	5	4	0	89	-89
t13	2	6	3	1	5	4	0	54	-54
t21	2	6	3	1	5	4	0	3	-3
t22	2	6	3	4	1	5	0	9	-9
t23	2	6	3	4	1	5	0	51	-51
t11	2	6	3	4	1	5	0	19	-19
t12	2	6	3	4	1	5	0	111	-111
t13	2	6	3	4	1	5	0	75	-75
t21	2	6	3	4	1	5	0	46	-46
t22	2	6	3	4	5	1	0	66	-66
t23	2	6	3	4	5	1	0	5	-5
t11	2	6	3	4	5	1	0	15	-15
t12	2	6	3	4	5	1	0	114	-114
t13	2	6	3	4	5	1	0	61	-61
t21	2	6	3	4	5	1	0	32	-32
t22	2	6	3	5	1	4	0	9	-9
t23	2	6	3	5	1	4	0	48	-48
t11	2	6	3	5	1	4	0	19	-19
t12	2	6	3	5	1	4	0	133	-133
t13	2	6	3	5	1	4	0	77	-77
t21	2	6	3	5	1	4	0	75	-75
t22	2	6	3	5	4	1	0	48	-48
t23	2	6	3	5	4	1	0	6	-6
t11	2	6	3	5	4	1	0	15	-15
t12	2	6	3	5	4	1	0	129	-129
t13	2	6	3	5	4	1	0	73	-73
t21	2	6	3	5	4	1	0	75	-75
t22	2	6	4	1	3	5	0	32	-32
t23	2	6	4	1	3	5	0	51	-51
t11	2	6	4	1	3	5	0	13	-13
t12	2	6	4	1	3	5	0	89	-89
t13	2	6	4	1	3	5	0	73	-73
t21	2	6	4	1	3	5	0	3	-3
t22	2	6	4	1	5	3	0	51	-51
t23	2	6	4	1	5	3	0	28	-28
t11	2	6	4	1	5	3	0	13	-13
t12	2	6	4	1	5	3	0	89	-89
t13	2	6	4	1	5	3	0	60	-60
t21	2	6	4	1	5	3	0	3	-3
t22	2	6	4	3	1	5	0	9	-9
t23	2	6	4	3	1	5	0	51	-51
t11	2	6	4	3	1	5	0	19	-19
t12	2	6	4	3	1	5	0	109	-109
t13	2	6	4	3	1	5	0	100	-100
t21	2	6	4	3	1	5	0	32	-32
t22	2	6	4	3	5	1	0	66	-66
t23	2	6	4	3	5	1	0	5	-5
t11	2	6	4	3	5	1	0	15	-15
t12	2	6	4	3	5	1	0	110	-110
t13	2	6	4	3	5	1	0	74	-74
t21	2	6	4	3	5	1	0	28	-28
t22	2	6	4	5	1	3	0	9	-9
t23	2	6	4	5	1	3	0	34	-34
t11	2	6	4	5	1	3	0	19	-19
t12	2	6	4	5	1	3	0	133	-133
t13	2	6	4	5	1	3	0	92	-92
t21	2	6	4	5	1	3	0	75	-75
t22	2	6	4	5	3	1	0	34	-34
t23	2	6	4	5	3	1	0	6	-6
t11	2	6	4	5	3	1	0	15	-15
t12	2	6	4	5	3	1	0	129	-129
t13	2	6	4	5	3	1	0	92	-92
t21	2	6	4	5	3	1	0	75	-75
t22	2	6	5	1	3	4	0	32	-32
t23	2	6	5	1	3	4	0	47	-47
t11	2	6	5	1	3	4	0	13	-13
t12	2	6	5	1	3	4	0	89	-89
t13	2	6	5	1	3	4	0	115	-115
t21	2	6	5	1	3	4	0	3	-3
t22	2	6	5	1	4	3	0	47	-47
t23	2	6	5	1	4	3	0	28	-28
t11	2	6	5	1	4	3	0	13	-13
t12	2	6	5	1	4	3	0	89	-89
t13	2	6	5	1	4	3	0	115	-115
t21	2	6	5	1	4	3	0	3	-3
t22	2	6	5	3	1	4	0	9	-9
t23	2	6	5	3	1	4	0	47	-47
t11	2	6	5	3	1	4	0	19	-19
t12	2	6	5	3	1	4	0	109	-109
t13	2	6	5	3	1	4	0	120	-120
t21	2	6	5	3	1	4	0	32	-32
t22	2	6	5	3	4	1	0	52	-52
t23	2	6	5	3	4	1	0	5	-5
t11	2	6	5	3	4	1	0	15	-15
t12	2	6	5	3	4	1	0	110	-110
t13	2	6	5	3	4	1	0	135	-135
t21	2	6	5	3	4	1	0	28	-28
t22	2	6	5	4	1	3	0	9	-9
t23	2	6	5	4	1	3	0	34	-34
t11	2	6	5	4	1	3	0	19	-19
t12	2	6	5	4	1	3	0	111	-111
t13	2	6	5	4	1	3	0	126	-126
t21	2	6	5	4	1	3	0	47	-47
t22	2	6	5	4	3	1	0	34	-34
t23	2	6	5	4	3	1	0	6	-6
t11	2	6	5	4	3	1	0	15	-15
t12	2	6	5	4	3	1	0	129	-129
t13	2	6	5	4	3	1	0	156	-156
t21	2	6	5	4	3	1	0	71	-71
t22	3	1	2	4	5	6	209	146	63
t23	3	1	2	4	5	6	558	466	92
t11	3	1	2	4	5	6	29	23	6
t12	3	1	2	4	5	6	3	3	0
t13	3	1	2	4	5	6	12	8	4
t21	3	1	2	4	5	6	95	73	22
t22	3	1	2	4	6	5	529	244	285
t23	3	1	2	4	6	5	255	147	108
t11	3	1	2	4	6	5	29	23	6
t12	3	1	2	4	6	5	3	3	0
t13	3	1	2	4	6	5	12	8	4
t21	3	1	2	4	6	5	95	73	22
t22	3	1	2	5	4	6	522	151	371
t23	3	1	2	5	4	6	2003	466	1537
t11	3	1	2	5	4	6	29	23	6
t12	3	1	2	5	4	6	3	3	0
t13	3	1	2	5	4	6	12	8	4
t21	3	1	2	5	4	6	948	155	793
t22	3	1	2	5	6	4	1213	265	948
t23	3	1	2	5	6	4	386	125	261
t11	3	1	2	5	6	4	29	23	6
t12	3	1	2	5	6	4	3	3	0
t13	3	1	2	5	6	4	12	8	4
t21	3	1	2	5	6	4	568	94	474
t22	3	1	2	6	4	5	0	191	-191
t23	3	1	2	6	4	5	0	183	-183
t11	3	1	2	6	4	5	0	23	-23
t12	3	1	2	6	4	5	0	3	-3
t13	3	1	2	6	4	5	0	8	-8
t21	3	1	2	6	4	5	0	213	-213
t22	3	1	2	6	5	4	0	212	-212
t23	3	1	2	6	5	4	0	142	-142
t11	3	1	2	6	5	4	0	23	-23
t12	3	1	2	6	5	4	0	3	-3
t13	3	1	2	6	5	4	0	8	-8
t21	3	1	2	6	5	4	0	213	-213
t22	3	1	4	2	5	6	133	133	0
t23	3	1	4	2	5	6	308	306	2
t11	3	1	4	2	5	6	17	17	0
t12	3	1	4	2	5	6	3	3	0
t13	3	1	4	2	5	6	47	47	0
t21	3	1	4	2	5	6	7	5	2
t22	3	1	4	2	6	5	294	176	118
t23	3	1	4	2	6	5	180	130	50
t11	3	1	4	2	6	5	17	17	0
t12	3	1	4	2	6	5	3	3	0
t13	3	1	4	2	6	5	47	47	0
t21	3	1	4	2	6	5	7	5	2
t22	3	1	4	5	2	6	0	19	-19
t23	3	1	4	5	2	6	0	435	-435
t11	3	1	4	5	2	6	0	23	-23
t12	3	1	4	5	2	6	0	3	-3
t13	3	1	4	5	2	6	0	58	-58
t21	3	1	4	5	2	6	0	155	-155
t22	3	1	4	5	6	2	0	265	-265
t23	3	1	4	5	6	2	0	9	-9
t11	3	1	4	5	6	2	0	19	-19
t12	3	1	4	5	6	2	0	3	-3
t13	3	1	4	5	6	2	0	49	-49
t21	3	1	4	5	6	2	0	94	-94
t22	3	1	4	6	2	5	0	27	-27
t23	3	1	4	6	2	5	0	166	-166
t11	3	1	4	6	2	5	0	23	-23
t12	3	1	4	6	2	5	0	3	-3
t13	3	1	4	6	2	5	0	58	-58
t21	3	1	4	6	2	5	0	213	-213
t22	3	1	4	6	5	2	0	212	-212
t23	3	1	4	6	5	2	0	10	-10
t11	3	1	4	6	5	2	0	19	-19
t12	3	1	4	6	5	2	0	3	-3
t13	3	1	4	6	5	2	0	49	-49
t21	3	1	4	6	5	2	0	213	-213
t22	3	1	5	2	4	6	50	50	0
t23	3	1	5	2	4	6	255	242	13
t11	3	1	5	2	4	6	17	17	0
t12	3	1	5	2	4	6	3	3	0
t13	3	1	5	2	4	6	68	68	0
t21	3	1	5	2	4	6	7	5	2
t22	3	1	5	2	6	4	294	176	118
t23	3	1	5	2	6	4	61	47	14
t11	3	1	5	2	6	4	17	17	0
t12	3	1	5	2	6	4	3	3	0
t13	3	1	5	2	6	4	110	52	58
t21	3	1	5	2	6	4	7	5	2
t22	3	1	5	4	2	6	15	11	4
t23	3	1	5	4	2	6	388	349	39
t11	3	1	5	4	2	6	25	23	2
t12	3	1	5	4	2	6	3	3	0
t13	3	1	5	4	2	6	99	89	10
t21	3	1	5	4	2	6	50	50	0
t22	3	1	5	4	6	2	808	205	603
t23	3	1	5	4	6	2	29	9	20
t11	3	1	5	4	6	2	76	19	57
t12	3	1	5	4	6	2	6	3	3
t13	3	1	5	4	6	2	249	53	196
t21	3	1	5	4	6	2	174	34	140
t22	3	1	5	6	2	4	0	27	-27
t23	3	1	5	6	2	4	0	66	-66
t11	3	1	5	6	2	4	0	23	-23
t12	3	1	5	6	2	4	0	3	-3
t13	3	1	5	6	2	4	0	75	-75
t21	3	1	5	6	2	4	0	213	-213
t22	3	1	5	6	4	2	0	92	-92
t23	3	1	5	6	4	2	0	9	-9
t11	3	1	5	6	4	2	0	19	-19
t12	3	1	5	6	4	2	0	3	-3
t13	3	1	5	6	4	2	0	71	-71
t21	3	1	5	6	4	2	0	213	-213
t22	3	1	6	2	4	5	50	50	0
t23	3	1	6	2	4	5	55	55	0
t11	3	1	6	2	4	5	17	17	0
t12	3	1	6	2	4	5	3	3	0
t13	3	1	6	2	4	5	113	113	0
t21	3	1	6	2	4	5	7	5	2
t22	3	1	6	2	5	4	72	72	0
t23	3	1	6	2	5	4	34	34	0
t11	3	1	6	2	5	4	17	17	0
t12	3	1	6	2	5	4	3	3	0
t13	3	1	6	2	5	4	130	130	0
t21	3	1	6	2	5	4	7	5	2
t22	3	1	6	4	2	5	15	11	4
t23	3	1	6	4	2	5	88	88	0
t11	3	1	6	4	2	5	25	23	2
t12	3	1	6	4	2	5	3	3	0
t13	3	1	6	4	2	5	155	141	14
t21	3	1	6	4	2	5	50	50	0
t22	3	1	6	4	5	2	74	72	2
t23	3	1	6	4	5	2	12	8	4
t11	3	1	6	4	5	2	26	19	7
t12	3	1	6	4	5	2	3	3	0
t13	3	1	6	4	5	2	163	133	30
t21	3	1	6	4	5	2	53	34	19
t22	3	1	6	5	2	4	20	12	8
t23	3	1	6	5	2	4	88	65	23
t11	3	1	6	5	2	4	36	23	13
t12	3	1	6	5	2	4	4	3	1
t13	3	1	6	5	2	4	189	158	31
t21	3	1	6	5	2	4	95	93	2
t22	3	1	6	5	4	2	113	65	48
t23	3	1	6	5	4	2	13	8	5
t11	3	1	6	5	4	2	33	19	14
t12	3	1	6	5	4	2	3	3	0
t13	3	1	6	5	4	2	229	154	75
t21	3	1	6	5	4	2	150	93	57
t22	3	2	1	4	5	6	234	146	88
t23	3	2	1	4	5	6	658	466	192
t11	3	2	1	4	5	6	39	23	16
t12	3	2	1	4	5	6	20	7	13
t13	3	2	1	4	5	6	10	6	4
t21	3	2	1	4	5	6	115	73	42
t22	3	2	1	4	6	5	591	244	347
t23	3	2	1	4	6	5	311	147	164
t11	3	2	1	4	6	5	39	23	16
t12	3	2	1	4	6	5	20	7	13
t13	3	2	1	4	6	5	10	6	4
t21	3	2	1	4	6	5	115	73	42
t22	3	2	1	5	4	6	681	151	530
t23	3	2	1	5	4	6	2518	466	2052
t11	3	2	1	5	4	6	39	23	16
t12	3	2	1	5	4	6	20	7	13
t13	3	2	1	5	4	6	10	6	4
t21	3	2	1	5	4	6	1195	155	1040
t22	3	2	1	5	6	4	1488	265	1223
t23	3	2	1	5	6	4	486	125	361
t11	3	2	1	5	6	4	39	23	16
t12	3	2	1	5	6	4	20	7	13
t13	3	2	1	5	6	4	10	6	4
t21	3	2	1	5	6	4	715	94	621
t22	3	2	1	6	4	5	0	191	-191
t23	3	2	1	6	4	5	0	183	-183
t11	3	2	1	6	4	5	0	23	-23
t12	3	2	1	6	4	5	0	7	-7
t13	3	2	1	6	4	5	0	6	-6
t21	3	2	1	6	4	5	0	213	-213
t22	3	2	1	6	5	4	0	212	-212
t23	3	2	1	6	5	4	0	142	-142
t11	3	2	1	6	5	4	0	23	-23
t12	3	2	1	6	5	4	0	7	-7
t13	3	2	1	6	5	4	0	6	-6
t21	3	2	1	6	5	4	0	213	-213
t22	3	2	4	1	5	6	133	133	0
t23	3	2	4	1	5	6	304	304	0
t11	3	2	4	1	5	6	17	17	0
t12	3	2	4	1	5	6	6	6	0
t13	3	2	4	1	5	6	47	47	0
t21	3	2	4	1	5	6	3	3	0
t22	3	2	4	1	6	5	294	175	119
t23	3	2	4	1	6	5	180	130	50
t11	3	2	4	1	6	5	17	17	0
t12	3	2	4	1	6	5	6	6	0
t13	3	2	4	1	6	5	47	47	0
t21	3	2	4	1	6	5	3	3	0
t22	3	2	4	5	1	6	0	17	-17
t23	3	2	4	5	1	6	0	433	-433
t11	3	2	4	5	1	6	0	23	-23
t12	3	2	4	5	1	6	0	12	-12
t13	3	2	4	5	1	6	0	67	-67
t21	3	2	4	5	1	6	0	155	-155
t22	3	2	4	5	6	1	0	265	-265
t23	3	2	4	5	6	1	0	7	-7
t11	3	2	4	5	6	1	0	19	-19
t12	3	2	4	5	6	1	0	8	-8
t13	3	2	4	5	6	1	0	49	-49
t21	3	2	4	5	6	1	0	94	-94
t22	3	2	4	6	1	5	0	25	-25
t23	3	2	4	6	1	5	0	166	-166
t11	3	2	4	6	1	5	0	23	-23
t12	3	2	4	6	1	5	0	12	-12
t13	3	2	4	6	1	5	0	67	-67
t21	3	2	4	6	1	5	0	213	-213
t22	3	2	4	6	5	1	0	212	-212
t23	3	2	4	6	5	1	0	8	-8
t11	3	2	4	6	5	1	0	19	-19
t12	3	2	4	6	5	1	0	8	-8
t13	3	2	4	6	5	1	0	49	-49
t21	3	2	4	6	5	1	0	213	-213
t22	3	2	5	1	4	6	50	50	0
t23	3	2	5	1	4	6	240	240	0
t11	3	2	5	1	4	6	17	17	0
t12	3	2	5	1	4	6	6	6	0
t13	3	2	5	1	4	6	68	68	0
t21	3	2	5	1	4	6	3	3	0
t22	3	2	5	1	6	4	294	175	119
t23	3	2	5	1	6	4	61	47	14
t11	3	2	5	1	6	4	17	17	0
t12	3	2	5	1	6	4	6	6	0
t13	3	2	5	1	6	4	113	54	59
t21	3	2	5	1	6	4	3	3	0
t22	3	2	5	4	1	6	9	9	0
t23	3	2	5	4	1	6	388	347	41
t11	3	2	5	4	1	6	25	23	2
t12	3	2	5	4	1	6	12	12	0
t13	3	2	5	4	1	6	106	91	15
t21	3	2	5	4	1	6	50	50	0
t22	3	2	5	4	6	1	1151	205	946
t23	3	2	5	4	6	1	17	7	10
t11	3	2	5	4	6	1	95	19	76
t12	3	2	5	4	6	1	72	8	64
t13	3	2	5	4	6	1	352	58	294
t21	3	2	5	4	6	1	215	34	181
t22	3	2	5	6	1	4	0	25	-25
t23	3	2	5	6	1	4	0	66	-66
t11	3	2	5	6	1	4	0	23	-23
t12	3	2	5	6	1	4	0	12	-12
t13	3	2	5	6	1	4	0	84	-84
t21	3	2	5	6	1	4	0	213	-213
t22	3	2	5	6	4	1	0	92	-92
t23	3	2	5	6	4	1	0	7	-7
t11	3	2	5	6	4	1	0	19	-19
t12	3	2	5	6	4	1	0	8	-8
t13	3	2	5	6	4	1	0	76	-76
t21	3	2	5	6	4	1	0	213	-213
t22	3	2	6	1	4	5	50	50	0
t23	3	2	6	1	4	5	55	55	0
t11	3	2	6	1	4	5	17	17	0
t12	3	2	6	1	4	5	6	6	0
t13	3	2	6	1	4	5	116	116	0
t21	3	2	6	1	4	5	3	3	0
t22	3	2	6	1	5	4	72	72	0
t23	3	2	6	1	5	4	34	34	0
t11	3	2	6	1	5	4	17	17	0
t12	3	2	6	1	5	4	6	6	0
t13	3	2	6	1	5	4	133	133	0
t21	3	2	6	1	5	4	3	3	0
t22	3	2	6	4	1	5	9	9	0
t23	3	2	6	4	1	5	88	88	0
t11	3	2	6	4	1	5	25	23	2
t12	3	2	6	4	1	5	12	12	0
t13	3	2	6	4	1	5	164	150	14
t21	3	2	6	4	1	5	50	50	0
t22	3	2	6	4	5	1	74	72	2
t23	3	2	6	4	5	1	6	6	0
t11	3	2	6	4	5	1	26	19	7
t12	3	2	6	4	5	1	13	8	5
t13	3	2	6	4	5	1	173	138	35
t21	3	2	6	4	5	1	53	34	19
t22	3	2	6	5	1	4	12	10	2
t23	3	2	6	5	1	4	88	65	23
t11	3	2	6	5	1	4	36	23	13
t12	3	2	6	5	1	4	22	12	10
t13	3	2	6	5	1	4	207	167	40
t21	3	2	6	5	1	4	95	93	2
t22	3	2	6	5	4	1	113	65	48
t23	3	2	6	5	4	1	7	6	1
t11	3	2	6	5	4	1	33	19	14
t12	3	2	6	5	4	1	18	8	10
t13	3	2	6	5	4	1	244	159	85
t21	3	2	6	5	4	1	150	93	57
t22	3	4	1	2	5	6	0	133	-133
t23	3	4	1	2	5	6	0	308	-308
t11	3	4	1	2	5	6	0	17	-17
t12	3	4	1	2	5	6	0	48	-48
t13	3	4	1	2	5	6	0	8	-8
t21	3	4	1	2	5	6	0	7	-7
t22	3	4	1	2	6	5	0	178	-178
t23	3	4	1	2	6	5	0	132	-132
t11	3	4	1	2	6	5	0	17	-17
t12	3	4	1	2	6	5	0	48	-48
t13	3	4	1	2	6	5	0	8	-8
t21	3	4	1	2	6	5	0	7	-7
t22	3	4	1	5	2	6	0	21	-21
t23	3	4	1	5	2	6	0	437	-437
t11	3	4	1	5	2	6	0	23	-23
t12	3	4	1	5	2	6	0	58	-58
t13	3	4	1	5	2	6	0	12	-12
t21	3	4	1	5	2	6	0	155	-155
t22	3	4	1	5	6	2	0	265	-265
t23	3	4	1	5	6	2	0	11	-11
t11	3	4	1	5	6	2	0	19	-19
t12	3	4	1	5	6	2	0	50	-50
t13	3	4	1	5	6	2	0	10	-10
t21	3	4	1	5	6	2	0	94	-94
t22	3	4	1	6	2	5	0	29	-29
t23	3	4	1	6	2	5	0	166	-166
t11	3	4	1	6	2	5	0	23	-23
t12	3	4	1	6	2	5	0	58	-58
t13	3	4	1	6	2	5	0	12	-12
t21	3	4	1	6	2	5	0	213	-213
t22	3	4	1	6	5	2	0	212	-212
t23	3	4	1	6	5	2	0	12	-12
t11	3	4	1	6	5	2	0	19	-19
t12	3	4	1	6	5	2	0	50	-50
t13	3	4	1	6	5	2	0	10	-10
t21	3	4	1	6	5	2	0	213	-213
t22	3	4	2	1	5	6	0	133	-133
t23	3	4	2	1	5	6	0	304	-304
t11	3	4	2	1	5	6	0	17	-17
t12	3	4	2	1	5	6	0	48	-48
t13	3	4	2	1	5	6	0	11	-11
t21	3	4	2	1	5	6	0	3	-3
t22	3	4	2	1	6	5	0	175	-175
t23	3	4	2	1	6	5	0	130	-130
t11	3	4	2	1	6	5	0	17	-17
t12	3	4	2	1	6	5	0	48	-48
t13	3	4	2	1	6	5	0	11	-11
t21	3	4	2	1	6	5	0	3	-3
t22	3	4	2	5	1	6	0	17	-17
t23	3	4	2	5	1	6	0	433	-433
t11	3	4	2	5	1	6	0	23	-23
t12	3	4	2	5	1	6	0	58	-58
t13	3	4	2	5	1	6	0	21	-21
t21	3	4	2	5	1	6	0	155	-155
t22	3	4	2	5	6	1	0	265	-265
t23	3	4	2	5	6	1	0	7	-7
t11	3	4	2	5	6	1	0	19	-19
t12	3	4	2	5	6	1	0	50	-50
t13	3	4	2	5	6	1	0	15	-15
t21	3	4	2	5	6	1	0	94	-94
t22	3	4	2	6	1	5	0	25	-25
t23	3	4	2	6	1	5	0	166	-166
t11	3	4	2	6	1	5	0	23	-23
t12	3	4	2	6	1	5	0	58	-58
t13	3	4	2	6	1	5	0	21	-21
t21	3	4	2	6	1	5	0	213	-213
t22	3	4	2	6	5	1	0	212	-212
t23	3	4	2	6	5	1	0	8	-8
t11	3	4	2	6	5	1	0	19	-19
t12	3	4	2	6	5	1	0	50	-50
t13	3	4	2	6	5	1	0	15	-15
t21	3	4	2	6	5	1	0	213	-213
t22	3	4	5	1	2	6	12	12	0
t23	3	4	5	1	2	6	371	202	169
t11	3	4	5	1	2	6	22	22	0
t12	3	4	5	1	2	6	45	45	0
t13	3	4	5	1	2	6	92	92	0
t21	3	4	5	1	2	6	3	3	0
t22	3	4	5	1	6	2	892	175	717
t23	3	4	5	1	6	2	17	9	8
t11	3	4	5	1	6	2	63	18	45
t12	3	4	5	1	6	2	146	31	115
t13	3	4	5	1	6	2	325	66	259
t21	3	4	5	1	6	2	3	3	0
t22	3	4	5	2	1	6	9	9	0
t23	3	4	5	2	1	6	371	268	103
t11	3	4	5	2	1	6	22	22	0
t12	3	4	5	2	1	6	45	45	0
t13	3	4	5	2	1	6	108	108	0
t21	3	4	5	2	1	6	12	12	0
t22	3	4	5	2	6	1	1111	179	932
t23	3	4	5	2	6	1	16	6	10
t11	3	4	5	2	6	1	73	18	55
t12	3	4	5	2	6	1	167	31	136
t13	3	4	5	2	6	1	379	66	313
t21	3	4	5	2	6	1	63	8	55
t22	3	4	5	6	1	2	0	25	-25
t23	3	4	5	6	1	2	0	16	-16
t11	3	4	5	6	1	2	0	24	-24
t12	3	4	5	6	1	2	0	47	-47
t13	3	4	5	6	1	2	0	100	-100
t21	3	4	5	6	1	2	0	213	-213
t22	3	4	5	6	2	1	0	30	-30
t23	3	4	5	6	2	1	0	7	-7
t11	3	4	5	6	2	1	0	24	-24
t12	3	4	5	6	2	1	0	47	-47
t13	3	4	5	6	2	1	0	100	-100
t21	3	4	5	6	2	1	0	213	-213
t22	3	4	6	1	2	5	12	12	0
t23	3	4	6	1	2	5	67	55	12
t11	3	4	6	1	2	5	22	22	0
t12	3	4	6	1	2	5	45	45	0
t13	3	4	6	1	2	5	142	142	0
t21	3	4	6	1	2	5	3	3	0
t22	3	4	6	1	5	2	72	72	0
t23	3	4	6	1	5	2	8	8	0
t11	3	4	6	1	5	2	18	18	0
t12	3	4	6	1	5	2	46	31	15
t13	3	4	6	1	5	2	145	145	0
t21	3	4	6	1	5	2	3	3	0
t22	3	4	6	2	1	5	9	9	0
t23	3	4	6	2	1	5	67	55	12
t11	3	4	6	2	1	5	22	22	0
t12	3	4	6	2	1	5	45	45	0
t13	3	4	6	2	1	5	147	147	0
t21	3	4	6	2	1	5	12	12	0
t22	3	4	6	2	5	1	72	72	0
t23	3	4	6	2	5	1	5	5	0
t11	3	4	6	2	5	1	18	18	0
t12	3	4	6	2	5	1	46	31	15
t13	3	4	6	2	5	1	147	145	2
t21	3	4	6	2	5	1	8	8	0
t22	3	4	6	5	1	2	12	10	2
t23	3	4	6	5	1	2	24	15	9
t11	3	4	6	5	1	2	38	24	14
t12	3	4	6	5	1	2	72	47	25
t13	3	4	6	5	1	2	241	203	38
t21	3	4	6	5	1	2	95	93	2
t22	3	4	6	5	2	1	27	15	12
t23	3	4	6	5	2	1	6	6	0
t11	3	4	6	5	2	1	38	24	14
t12	3	4	6	5	2	1	106	47	59
t13	3	4	6	5	2	1	288	203	85
t21	3	4	6	5	2	1	133	93	40
t22	3	5	1	2	4	6	0	46	-46
t23	3	5	1	2	4	6	0	255	-255
t11	3	5	1	2	4	6	0	17	-17
t12	3	5	1	2	4	6	0	69	-69
t13	3	5	1	2	4	6	0	11	-11
t21	3	5	1	2	4	6	0	7	-7
t22	3	5	1	2	6	4	0	178	-178
t23	3	5	1	2	6	4	0	43	-43
t11	3	5	1	2	6	4	0	17	-17
t12	3	5	1	2	6	4	0	53	-53
t13	3	5	1	2	6	4	0	10	-10
t21	3	5	1	2	6	4	0	7	-7
t22	3	5	1	4	2	6	0	13	-13
t23	3	5	1	4	2	6	0	306	-306
t11	3	5	1	4	2	6	0	23	-23
t12	3	5	1	4	2	6	0	86	-86
t13	3	5	1	4	2	6	0	14	-14
t21	3	5	1	4	2	6	0	46	-46
t22	3	5	1	4	6	2	0	203	-203
t23	3	5	1	4	6	2	0	11	-11
t11	3	5	1	4	6	2	0	19	-19
t12	3	5	1	4	6	2	0	53	-53
t13	3	5	1	4	6	2	0	10	-10
t21	3	5	1	4	6	2	0	32	-32
t22	3	5	1	6	2	4	0	29	-29
t23	3	5	1	6	2	4	0	60	-60
t11	3	5	1	6	2	4	0	23	-23
t12	3	5	1	6	2	4	0	73	-73
t13	3	5	1	6	2	4	0	12	-12
t21	3	5	1	6	2	4	0	213	-213
t22	3	5	1	6	4	2	0	84	-84
t23	3	5	1	6	4	2	0	11	-11
t11	3	5	1	6	4	2	0	19	-19
t12	3	5	1	6	4	2	0	69	-69
t13	3	5	1	6	4	2	0	12	-12
t21	3	5	1	6	4	2	0	213	-213
t22	3	5	2	1	4	6	0	46	-46
t23	3	5	2	1	4	6	0	236	-236
t11	3	5	2	1	4	6	0	17	-17
t12	3	5	2	1	4	6	0	69	-69
t13	3	5	2	1	4	6	0	14	-14
t21	3	5	2	1	4	6	0	3	-3
t22	3	5	2	1	6	4	0	175	-175
t23	3	5	2	1	6	4	0	43	-43
t11	3	5	2	1	6	4	0	17	-17
t12	3	5	2	1	6	4	0	53	-53
t13	3	5	2	1	6	4	0	13	-13
t21	3	5	2	1	6	4	0	3	-3
t22	3	5	2	4	1	6	0	9	-9
t23	3	5	2	4	1	6	0	302	-302
t11	3	5	2	4	1	6	0	23	-23
t12	3	5	2	4	1	6	0	86	-86
t13	3	5	2	4	1	6	0	23	-23
t21	3	5	2	4	1	6	0	46	-46
t22	3	5	2	4	6	1	0	203	-203
t23	3	5	2	4	6	1	0	7	-7
t11	3	5	2	4	6	1	0	19	-19
t12	3	5	2	4	6	1	0	53	-53
t13	3	5	2	4	6	1	0	15	-15
t21	3	5	2	4	6	1	0	32	-32
t22	3	5	2	6	1	4	0	25	-25
t23	3	5	2	6	1	4	0	60	-60
t11	3	5	2	6	1	4	0	23	-23
t12	3	5	2	6	1	4	0	73	-73
t13	3	5	2	6	1	4	0	21	-21
t21	3	5	2	6	1	4	0	213	-213
t22	3	5	2	6	4	1	0	84	-84
t23	3	5	2	6	4	1	0	7	-7
t11	3	5	2	6	4	1	0	19	-19
t12	3	5	2	6	4	1	0	69	-69
t13	3	5	2	6	4	1	0	17	-17
t21	3	5	2	6	4	1	0	213	-213
t22	3	5	4	1	2	6	0	12	-12
t23	3	5	4	1	2	6	0	202	-202
t11	3	5	4	1	2	6	0	22	-22
t12	3	5	4	1	2	6	0	74	-74
t13	3	5	4	1	2	6	0	64	-64
t21	3	5	4	1	2	6	0	3	-3
t22	3	5	4	1	6	2	0	175	-175
t23	3	5	4	1	6	2	0	9	-9
t11	3	5	4	1	6	2	0	18	-18
t12	3	5	4	1	6	2	0	53	-53
t13	3	5	4	1	6	2	0	56	-56
t21	3	5	4	1	6	2	0	3	-3
t22	3	5	4	2	1	6	0	9	-9
t23	3	5	4	2	1	6	0	268	-268
t11	3	5	4	2	1	6	0	22	-22
t12	3	5	4	2	1	6	0	78	-78
t13	3	5	4	2	1	6	0	68	-68
t21	3	5	4	2	1	6	0	12	-12
t22	3	5	4	2	6	1	0	179	-179
t23	3	5	4	2	6	1	0	6	-6
t11	3	5	4	2	6	1	0	18	-18
t12	3	5	4	2	6	1	0	53	-53
t13	3	5	4	2	6	1	0	56	-56
t21	3	5	4	2	6	1	0	8	-8
t22	3	5	4	6	1	2	0	25	-25
t23	3	5	4	6	1	2	0	16	-16
t11	3	5	4	6	1	2	0	24	-24
t12	3	5	4	6	1	2	0	74	-74
t13	3	5	4	6	1	2	0	68	-68
t21	3	5	4	6	1	2	0	213	-213
t22	3	5	4	6	2	1	0	30	-30
t23	3	5	4	6	2	1	0	7	-7
t11	3	5	4	6	2	1	0	24	-24
t12	3	5	4	6	2	1	0	74	-74
t13	3	5	4	6	2	1	0	68	-68
t21	3	5	4	6	2	1	0	213	-213
t22	3	5	6	1	2	4	12	12	0
t23	3	5	6	1	2	4	47	47	0
t11	3	5	6	1	2	4	22	22	0
t12	3	5	6	1	2	4	50	50	0
t13	3	5	6	1	2	4	146	146	0
t21	3	5	6	1	2	4	3	3	0
t22	3	5	6	1	4	2	47	47	0
t23	3	5	6	1	4	2	8	8	0
t11	3	5	6	1	4	2	18	18	0
t12	3	5	6	1	4	2	50	50	0
t13	3	5	6	1	4	2	142	142	0
t21	3	5	6	1	4	2	3	3	0
t22	3	5	6	2	1	4	9	9	0
t23	3	5	6	2	1	4	47	47	0
t11	3	5	6	2	1	4	22	22	0
t12	3	5	6	2	1	4	50	50	0
t13	3	5	6	2	1	4	162	162	0
t21	3	5	6	2	1	4	12	12	0
t22	3	5	6	2	4	1	47	47	0
t23	3	5	6	2	4	1	5	5	0
t11	3	5	6	2	4	1	18	18	0
t12	3	5	6	2	4	1	65	65	0
t13	3	5	6	2	4	1	158	158	0
t21	3	5	6	2	4	1	8	8	0
t22	3	5	6	4	1	2	9	9	0
t23	3	5	6	4	1	2	14	14	0
t11	3	5	6	4	1	2	24	24	0
t12	3	5	6	4	1	2	75	75	0
t13	3	5	6	4	1	2	190	182	8
t21	3	5	6	4	1	2	47	47	0
t22	3	5	6	4	2	1	14	14	0
t23	3	5	6	4	2	1	5	5	0
t11	3	5	6	4	2	1	33	24	9
t12	3	5	6	4	2	1	80	75	5
t13	3	5	6	4	2	1	231	214	17
t21	3	5	6	4	2	1	71	71	0
t22	3	6	1	2	4	5	0	46	-46
t23	3	6	1	2	4	5	0	51	-51
t11	3	6	1	2	4	5	0	17	-17
t12	3	6	1	2	4	5	0	93	-93
t13	3	6	1	2	4	5	0	14	-14
t21	3	6	1	2	4	5	0	7	-7
t22	3	6	1	2	5	4	0	66	-66
t23	3	6	1	2	5	4	0	32	-32
t11	3	6	1	2	5	4	0	17	-17
t12	3	6	1	2	5	4	0	94	-94
t13	3	6	1	2	5	4	0	14	-14
t21	3	6	1	2	5	4	0	7	-7
t22	3	6	1	4	2	5	0	13	-13
t23	3	6	1	4	2	5	0	51	-51
t11	3	6	1	4	2	5	0	23	-23
t12	3	6	1	4	2	5	0	115	-115
t13	3	6	1	4	2	5	0	16	-16
t21	3	6	1	4	2	5	0	46	-46
t22	3	6	1	4	5	2	0	66	-66
t23	3	6	1	4	5	2	0	9	-9
t11	3	6	1	4	5	2	0	19	-19
t12	3	6	1	4	5	2	0	114	-114
t13	3	6	1	4	5	2	0	16	-16
t21	3	6	1	4	5	2	0	32	-32
t22	3	6	1	5	2	4	0	13	-13
t23	3	6	1	5	2	4	0	48	-48
t11	3	6	1	5	2	4	0	23	-23
t12	3	6	1	5	2	4	0	137	-137
t13	3	6	1	5	2	4	0	18	-18
t21	3	6	1	5	2	4	0	75	-75
t22	3	6	1	5	4	2	0	48	-48
t23	3	6	1	5	4	2	0	10	-10
t11	3	6	1	5	4	2	0	19	-19
t12	3	6	1	5	4	2	0	133	-133
t13	3	6	1	5	4	2	0	18	-18
t21	3	6	1	5	4	2	0	75	-75
t22	3	6	2	1	4	5	0	46	-46
t23	3	6	2	1	4	5	0	51	-51
t11	3	6	2	1	4	5	0	17	-17
t12	3	6	2	1	4	5	0	93	-93
t13	3	6	2	1	4	5	0	17	-17
t21	3	6	2	1	4	5	0	3	-3
t22	3	6	2	1	5	4	0	51	-51
t23	3	6	2	1	5	4	0	32	-32
t11	3	6	2	1	5	4	0	17	-17
t12	3	6	2	1	5	4	0	93	-93
t13	3	6	2	1	5	4	0	17	-17
t21	3	6	2	1	5	4	0	3	-3
t22	3	6	2	4	1	5	0	9	-9
t23	3	6	2	4	1	5	0	51	-51
t11	3	6	2	4	1	5	0	23	-23
t12	3	6	2	4	1	5	0	115	-115
t13	3	6	2	4	1	5	0	25	-25
t21	3	6	2	4	1	5	0	46	-46
t22	3	6	2	4	5	1	0	66	-66
t23	3	6	2	4	5	1	0	5	-5
t11	3	6	2	4	5	1	0	19	-19
t12	3	6	2	4	5	1	0	114	-114
t13	3	6	2	4	5	1	0	21	-21
t21	3	6	2	4	5	1	0	32	-32
t22	3	6	2	5	1	4	0	9	-9
t23	3	6	2	5	1	4	0	48	-48
t11	3	6	2	5	1	4	0	23	-23
t12	3	6	2	5	1	4	0	137	-137
t13	3	6	2	5	1	4	0	27	-27
t21	3	6	2	5	1	4	0	75	-75
t22	3	6	2	5	4	1	0	48	-48
t23	3	6	2	5	4	1	0	6	-6
t11	3	6	2	5	4	1	0	19	-19
t12	3	6	2	5	4	1	0	133	-133
t13	3	6	2	5	4	1	0	23	-23
t21	3	6	2	5	4	1	0	75	-75
t22	3	6	4	1	2	5	0	12	-12
t23	3	6	4	1	2	5	0	51	-51
t11	3	6	4	1	2	5	0	22	-22
t12	3	6	4	1	2	5	0	98	-98
t13	3	6	4	1	2	5	0	76	-76
t21	3	6	4	1	2	5	0	3	-3
t22	3	6	4	1	5	2	0	51	-51
t23	3	6	4	1	5	2	0	8	-8
t11	3	6	4	1	5	2	0	18	-18
t12	3	6	4	1	5	2	0	94	-94
t13	3	6	4	1	5	2	0	62	-62
t21	3	6	4	1	5	2	0	3	-3
t22	3	6	4	2	1	5	0	9	-9
t23	3	6	4	2	1	5	0	51	-51
t11	3	6	4	2	1	5	0	22	-22
t12	3	6	4	2	1	5	0	112	-112
t13	3	6	4	2	1	5	0	100	-100
t21	3	6	4	2	1	5	0	12	-12
t22	3	6	4	2	5	1	0	66	-66
t23	3	6	4	2	5	1	0	5	-5
t11	3	6	4	2	5	1	0	18	-18
t12	3	6	4	2	5	1	0	109	-109
t13	3	6	4	2	5	1	0	73	-73
t21	3	6	4	2	5	1	0	8	-8
t22	3	6	4	5	1	2	0	9	-9
t23	3	6	4	5	1	2	0	14	-14
t11	3	6	4	5	1	2	0	24	-24
t12	3	6	4	5	1	2	0	138	-138
t13	3	6	4	5	1	2	0	92	-92
t21	3	6	4	5	1	2	0	75	-75
t22	3	6	4	5	2	1	0	14	-14
t23	3	6	4	5	2	1	0	5	-5
t11	3	6	4	5	2	1	0	24	-24
t12	3	6	4	5	2	1	0	138	-138
t13	3	6	4	5	2	1	0	92	-92
t21	3	6	4	5	2	1	0	75	-75
t22	3	6	5	1	2	4	0	12	-12
t23	3	6	5	1	2	4	0	47	-47
t11	3	6	5	1	2	4	0	22	-22
t12	3	6	5	1	2	4	0	98	-98
t13	3	6	5	1	2	4	0	118	-118
t21	3	6	5	1	2	4	0	3	-3
t22	3	6	5	1	4	2	0	47	-47
t23	3	6	5	1	4	2	0	8	-8
t11	3	6	5	1	4	2	0	18	-18
t12	3	6	5	1	4	2	0	94	-94
t13	3	6	5	1	4	2	0	118	-118
t21	3	6	5	1	4	2	0	3	-3
t22	3	6	5	2	1	4	0	9	-9
t23	3	6	5	2	1	4	0	47	-47
t11	3	6	5	2	1	4	0	22	-22
t12	3	6	5	2	1	4	0	112	-112
t13	3	6	5	2	1	4	0	120	-120
t21	3	6	5	2	1	4	0	12	-12
t22	3	6	5	2	4	1	0	47	-47
t23	3	6	5	2	4	1	0	5	-5
t11	3	6	5	2	4	1	0	18	-18
t12	3	6	5	2	4	1	0	108	-108
t13	3	6	5	2	4	1	0	118	-118
t21	3	6	5	2	4	1	0	8	-8
t22	3	6	5	4	1	2	0	9	-9
t23	3	6	5	4	1	2	0	14	-14
t11	3	6	5	4	1	2	0	24	-24
t12	3	6	5	4	1	2	0	116	-116
t13	3	6	5	4	1	2	0	131	-131
t21	3	6	5	4	1	2	0	47	-47
t22	3	6	5	4	2	1	0	14	-14
t23	3	6	5	4	2	1	0	5	-5
t11	3	6	5	4	2	1	0	24	-24
t12	3	6	5	4	2	1	0	138	-138
t13	3	6	5	4	2	1	0	156	-156
t21	3	6	5	4	2	1	0	71	-71
t22	4	1	2	3	5	6	155	133	22
t23	4	1	2	3	5	6	432	310	122
t11	4	1	2	3	5	6	38	26	12
t12	4	1	2	3	5	6	4	3	1
t13	4	1	2	3	5	6	14	8	6
t21	4	1	2	3	5	6	27	9	18
t22	4	1	2	3	6	5	433	180	253
t23	4	1	2	3	6	5	238	134	104
t11	4	1	2	3	6	5	38	26	12
t12	4	1	2	3	6	5	4	3	1
t13	4	1	2	3	6	5	14	8	6
t21	4	1	2	3	6	5	27	9	18
t22	4	1	2	5	3	6	0	23	-23
t23	4	1	2	5	3	6	0	439	-439
t11	4	1	2	5	3	6	0	32	-32
t12	4	1	2	5	3	6	0	3	-3
t13	4	1	2	5	3	6	0	9	-9
t21	4	1	2	5	3	6	0	155	-155
t22	4	1	2	5	6	3	0	265	-265
t23	4	1	2	5	6	3	0	13	-13
t11	4	1	2	5	6	3	0	28	-28
t12	4	1	2	5	6	3	0	3	-3
t13	4	1	2	5	6	3	0	8	-8
t21	4	1	2	5	6	3	0	94	-94
t22	4	1	2	6	3	5	0	31	-31
t23	4	1	2	6	3	5	0	166	-166
t11	4	1	2	6	3	5	0	32	-32
t12	4	1	2	6	3	5	0	3	-3
t13	4	1	2	6	3	5	0	9	-9
t21	4	1	2	6	3	5	0	213	-213
t22	4	1	2	6	5	3	0	212	-212
t23	4	1	2	6	5	3	0	14	-14
t11	4	1	2	6	5	3	0	28	-28
t12	4	1	2	6	5	3	0	3	-3
t13	4	1	2	6	5	3	0	8	-8
t21	4	1	2	6	5	3	0	213	-213
t22	4	1	3	2	5	6	155	133	22
t23	4	1	3	2	5	6	414	306	108
t11	4	1	3	2	5	6	38	26	12
t12	4	1	3	2	5	6	4	3	1
t13	4	1	3	2	5	6	19	11	8
t21	4	1	3	2	5	6	9	5	4
t22	4	1	3	2	6	5	393	176	217
t23	4	1	3	2	6	5	238	130	108
t11	4	1	3	2	6	5	38	26	12
t12	4	1	3	2	6	5	4	3	1
t13	4	1	3	2	6	5	19	11	8
t21	4	1	3	2	6	5	9	5	4
t22	4	1	3	5	2	6	0	19	-19
t23	4	1	3	5	2	6	0	435	-435
t11	4	1	3	5	2	6	0	32	-32
t12	4	1	3	5	2	6	0	3	-3
t13	4	1	3	5	2	6	0	18	-18
t21	4	1	3	5	2	6	0	155	-155
t22	4	1	3	5	6	2	0	265	-265
t23	4	1	3	5	6	2	0	9	-9
t11	4	1	3	5	6	2	0	28	-28
t12	4	1	3	5	6	2	0	3	-3
t13	4	1	3	5	6	2	0	13	-13
t21	4	1	3	5	6	2	0	94	-94
t22	4	1	3	6	2	5	0	27	-27
t23	4	1	3	6	2	5	0	166	-166
t11	4	1	3	6	2	5	0	32	-32
t12	4	1	3	6	2	5	0	3	-3
t13	4	1	3	6	2	5	0	18	-18
t21	4	1	3	6	2	5	0	213	-213
t22	4	1	3	6	5	2	0	212	-212
t23	4	1	3	6	5	2	0	10	-10
t11	4	1	3	6	5	2	0	28	-28
t12	4	1	3	6	5	2	0	3	-3
t13	4	1	3	6	5	2	0	13	-13
t21	4	1	3	6	5	2	0	213	-213
t22	4	1	5	2	3	6	18	14	4
t23	4	1	5	2	3	6	288	206	82
t11	4	1	5	2	3	6	28	26	2
t12	4	1	5	2	3	6	3	3	0
t13	4	1	5	2	3	6	84	68	16
t21	4	1	5	2	3	6	7	5	2
t22	4	1	5	2	6	3	492	176	316
t23	4	1	5	2	6	3	25	11	14
t11	4	1	5	2	6	3	55	22	33
t12	4	1	5	2	6	3	5	3	2
t13	4	1	5	2	6	3	165	56	109
t21	4	1	5	2	6	3	11	5	6
t22	4	1	5	3	2	6	15	11	4
t23	4	1	5	3	2	6	347	272	75
t11	4	1	5	3	2	6	28	26	2
t12	4	1	5	3	2	6	3	3	0
t13	4	1	5	3	2	6	104	84	20
t21	4	1	5	3	2	6	18	14	4
t22	4	1	5	3	6	2	553	181	372
t23	4	1	5	3	6	2	23	8	15
t11	4	1	5	3	6	2	62	22	40
t12	4	1	5	3	6	2	5	3	2
t13	4	1	5	3	6	2	194	56	138
t21	4	1	5	3	6	2	50	10	40
t22	4	1	5	6	2	3	0	27	-27
t23	4	1	5	6	2	3	0	18	-18
t11	4	1	5	6	2	3	0	28	-28
t12	4	1	5	6	2	3	0	3	-3
t13	4	1	5	6	2	3	0	80	-80
t21	4	1	5	6	2	3	0	213	-213
t22	4	1	5	6	3	2	0	32	-32
t23	4	1	5	6	3	2	0	9	-9
t11	4	1	5	6	3	2	0	28	-28
t12	4	1	5	6	3	2	0	3	-3
t13	4	1	5	6	3	2	0	80	-80
t21	4	1	5	6	3	2	0	213	-213
t22	4	1	6	2	3	5	18	14	4
t23	4	1	6	2	3	5	67	55	12
t11	4	1	6	2	3	5	28	26	2
t12	4	1	6	2	3	5	3	3	0
t13	4	1	6	2	3	5	126	122	4
t21	4	1	6	2	3	5	7	5	2
t22	4	1	6	2	5	3	72	72	0
t23	4	1	6	2	5	3	12	10	2
t11	4	1	6	2	5	3	26	22	4
t12	4	1	6	2	5	3	3	3	0
t13	4	1	6	2	5	3	137	135	2
t21	4	1	6	2	5	3	7	5	2
t22	4	1	6	3	2	5	15	11	4
t23	4	1	6	3	2	5	67	55	12
t11	4	1	6	3	2	5	28	26	2
t12	4	1	6	3	2	5	3	3	0
t13	4	1	6	3	2	5	127	122	5
t21	4	1	6	3	2	5	18	14	4
t22	4	1	6	3	5	2	74	72	2
t23	4	1	6	3	5	2	11	7	4
t11	4	1	6	3	5	2	31	22	9
t12	4	1	6	3	5	2	3	3	0
t13	4	1	6	3	5	2	146	135	11
t21	4	1	6	3	5	2	14	10	4
t22	4	1	6	5	2	3	25	12	13
t23	4	1	6	5	2	3	34	17	17
t11	4	1	6	5	2	3	51	28	23
t12	4	1	6	5	2	3	4	3	1
t13	4	1	6	5	2	3	225	163	62
t21	4	1	6	5	2	3	135	93	42
t22	4	1	6	5	3	2	37	17	20
t23	4	1	6	5	3	2	14	8	6
t11	4	1	6	5	3	2	61	28	33
t12	4	1	6	5	3	2	5	3	2
t13	4	1	6	5	3	2	249	163	86
t21	4	1	6	5	3	2	135	93	42
t22	4	2	1	3	5	6	226	133	93
t23	4	2	1	3	5	6	619	310	309
t11	4	2	1	3	5	6	48	26	22
t12	4	2	1	3	5	6	24	7	17
t13	4	2	1	3	5	6	11	6	5
t21	4	2	1	3	5	6	37	9	28
t22	4	2	1	3	6	5	584	180	404
t23	4	2	1	3	6	5	343	134	209
t11	4	2	1	3	6	5	48	26	22
t12	4	2	1	3	6	5	24	7	17
t13	4	2	1	3	6	5	11	6	5
t21	4	2	1	3	6	5	37	9	28
t22	4	2	1	5	3	6	0	23	-23
t23	4	2	1	5	3	6	0	439	-439
t11	4	2	1	5	3	6	0	32	-32
t12	4	2	1	5	3	6	0	7	-7
t13	4	2	1	5	3	6	0	8	-8
t21	4	2	1	5	3	6	0	155	-155
t22	4	2	1	5	6	3	0	265	-265
t23	4	2	1	5	6	3	0	13	-13
t11	4	2	1	5	6	3	0	28	-28
t12	4	2	1	5	6	3	0	7	-7
t13	4	2	1	5	6	3	0	7	-7
t21	4	2	1	5	6	3	0	94	-94
t22	4	2	1	6	3	5	0	31	-31
t23	4	2	1	6	3	5	0	166	-166
t11	4	2	1	6	3	5	0	32	-32
t12	4	2	1	6	3	5	0	7	-7
t13	4	2	1	6	3	5	0	8	-8
t21	4	2	1	6	3	5	0	213	-213
t22	4	2	1	6	5	3	0	212	-212
t23	4	2	1	6	5	3	0	14	-14
t11	4	2	1	6	5	3	0	28	-28
t12	4	2	1	6	5	3	0	7	-7
t13	4	2	1	6	5	3	0	7	-7
t21	4	2	1	6	5	3	0	213	-213
t22	4	2	3	1	5	6	187	133	54
t23	4	2	3	1	5	6	472	304	168
t11	4	2	3	1	5	6	44	26	18
t12	4	2	3	1	5	6	7	6	1
t13	4	2	3	1	5	6	19	11	8
t21	4	2	3	1	5	6	3	3	0
t22	4	2	3	1	6	5	449	175	274
t23	4	2	3	1	6	5	257	130	127
t11	4	2	3	1	6	5	44	26	18
t12	4	2	3	1	6	5	7	6	1
t13	4	2	3	1	6	5	19	11	8
t21	4	2	3	1	6	5	3	3	0
t22	4	2	3	5	1	6	0	17	-17
t23	4	2	3	5	1	6	0	433	-433
t11	4	2	3	5	1	6	0	32	-32
t12	4	2	3	5	1	6	0	12	-12
t13	4	2	3	5	1	6	0	19	-19
t21	4	2	3	5	1	6	0	155	-155
t22	4	2	3	5	6	1	0	265	-265
t23	4	2	3	5	6	1	0	7	-7
t11	4	2	3	5	6	1	0	28	-28
t12	4	2	3	5	6	1	0	8	-8
t13	4	2	3	5	6	1	0	15	-15
t21	4	2	3	5	6	1	0	94	-94
t22	4	2	3	6	1	5	0	25	-25
t23	4	2	3	6	1	5	0	166	-166
t11	4	2	3	6	1	5	0	32	-32
t12	4	2	3	6	1	5	0	12	-12
t13	4	2	3	6	1	5	0	19	-19
t21	4	2	3	6	1	5	0	213	-213
t22	4	2	3	6	5	1	0	212	-212
t23	4	2	3	6	5	1	0	8	-8
t11	4	2	3	6	5	1	0	28	-28
t12	4	2	3	6	5	1	0	8	-8
t13	4	2	3	6	5	1	0	15	-15
t21	4	2	3	6	5	1	0	213	-213
t22	4	2	5	1	3	6	18	14	4
t23	4	2	5	1	3	6	293	204	89
t11	4	2	5	1	3	6	28	26	2
t12	4	2	5	1	3	6	6	6	0
t13	4	2	5	1	3	6	87	68	19
t21	4	2	5	1	3	6	3	3	0
t22	4	2	5	1	6	3	492	175	317
t23	4	2	5	1	6	3	25	11	14
t11	4	2	5	1	6	3	55	22	33
t12	4	2	5	1	6	3	8	6	2
t13	4	2	5	1	6	3	165	59	106
t21	4	2	5	1	6	3	3	3	0
t22	4	2	5	3	1	6	9	9	0
t23	4	2	5	3	1	6	353	270	83
t11	4	2	5	3	1	6	28	26	2
t12	4	2	5	3	1	6	12	12	0
t13	4	2	5	3	1	6	108	93	15
t21	4	2	5	3	1	6	18	14	4
t22	4	2	5	3	6	1	795	181	614
t23	4	2	5	3	6	1	13	6	7
t11	4	2	5	3	6	1	74	22	52
t12	4	2	5	3	6	1	51	8	43
t13	4	2	5	3	6	1	256	61	195
t21	4	2	5	3	6	1	62	10	52
t22	4	2	5	6	1	3	0	25	-25
t23	4	2	5	6	1	3	0	18	-18
t11	4	2	5	6	1	3	0	28	-28
t12	4	2	5	6	1	3	0	12	-12
t13	4	2	5	6	1	3	0	84	-84
t21	4	2	5	6	1	3	0	213	-213
t22	4	2	5	6	3	1	0	32	-32
t23	4	2	5	6	3	1	0	7	-7
t11	4	2	5	6	3	1	0	28	-28
t12	4	2	5	6	3	1	0	8	-8
t13	4	2	5	6	3	1	0	84	-84
t21	4	2	5	6	3	1	0	213	-213
t22	4	2	6	1	3	5	18	14	4
t23	4	2	6	1	3	5	67	55	12
t11	4	2	6	1	3	5	28	26	2
t12	4	2	6	1	3	5	6	6	0
t13	4	2	6	1	3	5	129	125	4
t21	4	2	6	1	3	5	3	3	0
t22	4	2	6	1	5	3	72	72	0
t23	4	2	6	1	5	3	12	10	2
t11	4	2	6	1	5	3	26	22	4
t12	4	2	6	1	5	3	6	6	0
t13	4	2	6	1	5	3	140	138	2
t21	4	2	6	1	5	3	3	3	0
t22	4	2	6	3	1	5	9	9	0
t23	4	2	6	3	1	5	67	55	12
t11	4	2	6	3	1	5	28	26	2
t12	4	2	6	3	1	5	12	12	0
t13	4	2	6	3	1	5	132	128	4
t21	4	2	6	3	1	5	18	14	4
t22	4	2	6	3	5	1	74	72	2
t23	4	2	6	3	5	1	5	5	0
t11	4	2	6	3	5	1	31	22	9
t12	4	2	6	3	5	1	8	8	0
t13	4	2	6	3	5	1	148	140	8
t21	4	2	6	3	5	1	14	10	4
t22	4	2	6	5	1	3	17	10	7
t23	4	2	6	5	1	3	34	17	17
t11	4	2	6	5	1	3	51	28	23
t12	4	2	6	5	1	3	22	12	10
t13	4	2	6	5	1	3	242	172	70
t21	4	2	6	5	1	3	135	93	42
t22	4	2	6	5	3	1	37	17	20
t23	4	2	6	5	3	1	6	6	0
t11	4	2	6	5	3	1	61	28	33
t12	4	2	6	5	3	1	15	8	7
t13	4	2	6	5	3	1	259	168	91
t21	4	2	6	5	3	1	135	93	42
t22	4	3	1	2	5	6	232	133	99
t23	4	3	1	2	5	6	608	308	300
t11	4	3	1	2	5	6	54	26	28
t12	4	3	1	2	5	6	32	10	22
t13	4	3	1	2	5	6	12	8	4
t21	4	3	1	2	5	6	27	7	20
t22	4	3	1	2	6	5	580	178	402
t23	4	3	1	2	6	5	349	132	217
t11	4	3	1	2	6	5	54	26	28
t12	4	3	1	2	6	5	32	10	22
t13	4	3	1	2	6	5	12	8	4
t21	4	3	1	2	6	5	27	7	20
t22	4	3	1	5	2	6	0	21	-21
t23	4	3	1	5	2	6	0	437	-437
t11	4	3	1	5	2	6	0	32	-32
t12	4	3	1	5	2	6	0	16	-16
t13	4	3	1	5	2	6	0	8	-8
t21	4	3	1	5	2	6	0	155	-155
t22	4	3	1	5	6	2	0	265	-265
t23	4	3	1	5	6	2	0	11	-11
t11	4	3	1	5	6	2	0	28	-28
t12	4	3	1	5	6	2	0	12	-12
t13	4	3	1	5	6	2	0	8	-8
t21	4	3	1	5	6	2	0	94	-94
t22	4	3	1	6	2	5	0	29	-29
t23	4	3	1	6	2	5	0	166	-166
t11	4	3	1	6	2	5	0	32	-32
t12	4	3	1	6	2	5	0	16	-16
t13	4	3	1	6	2	5	0	8	-8
t21	4	3	1	6	2	5	0	213	-213
t22	4	3	1	6	5	2	0	212	-212
t23	4	3	1	6	5	2	0	12	-12
t11	4	3	1	6	5	2	0	28	-28
t12	4	3	1	6	5	2	0	12	-12
t13	4	3	1	6	5	2	0	8	-8
t21	4	3	1	6	5	2	0	213	-213
t22	4	3	2	1	5	6	232	133	99
t23	4	3	2	1	5	6	565	304	261
t11	4	3	2	1	5	6	54	26	28
t12	4	3	2	1	5	6	32	10	22
t13	4	3	2	1	5	6	15	11	4
t21	4	3	2	1	5	6	3	3	0
t22	4	3	2	1	6	5	573	175	398
t23	4	3	2	1	6	5	344	130	214
t11	4	3	2	1	6	5	54	26	28
t12	4	3	2	1	6	5	32	10	22
t13	4	3	2	1	6	5	15	11	4
t21	4	3	2	1	6	5	3	3	0
t22	4	3	2	5	1	6	0	17	-17
t23	4	3	2	5	1	6	0	433	-433
t11	4	3	2	5	1	6	0	32	-32
t12	4	3	2	5	1	6	0	16	-16
t13	4	3	2	5	1	6	0	17	-17
t21	4	3	2	5	1	6	0	155	-155
t22	4	3	2	5	6	1	0	265	-265
t23	4	3	2	5	6	1	0	7	-7
t11	4	3	2	5	6	1	0	28	-28
t12	4	3	2	5	6	1	0	12	-12
t13	4	3	2	5	6	1	0	13	-13
t21	4	3	2	5	6	1	0	94	-94
t22	4	3	2	6	1	5	0	25	-25
t23	4	3	2	6	1	5	0	166	-166
t11	4	3	2	6	1	5	0	32	-32
t12	4	3	2	6	1	5	0	16	-16
t13	4	3	2	6	1	5	0	17	-17
t21	4	3	2	6	1	5	0	213	-213
t22	4	3	2	6	5	1	0	212	-212
t23	4	3	2	6	5	1	0	8	-8
t11	4	3	2	6	5	1	0	28	-28
t12	4	3	2	6	5	1	0	12	-12
t13	4	3	2	6	5	1	0	13	-13
t21	4	3	2	6	5	1	0	213	-213
t22	4	3	5	1	2	6	12	12	0
t23	4	3	5	1	2	6	293	202	91
t11	4	3	5	1	2	6	28	26	2
t12	4	3	5	1	2	6	15	15	0
t13	4	3	5	1	2	6	96	76	20
t21	4	3	5	1	2	6	3	3	0
t22	4	3	5	1	6	2	593	175	418
t23	4	3	5	1	6	2	14	9	5
t11	4	3	5	1	6	2	62	22	40
t12	4	3	5	1	6	2	43	11	32
t13	4	3	5	1	6	2	218	64	154
t21	4	3	5	1	6	2	3	3	0
t22	4	3	5	2	1	6	9	9	0
t23	4	3	5	2	1	6	353	268	85
t11	4	3	5	2	1	6	28	26	2
t12	4	3	5	2	1	6	15	15	0
t13	4	3	5	2	1	6	110	96	14
t21	4	3	5	2	1	6	12	12	0
t22	4	3	5	2	6	1	753	179	574
t23	4	3	5	2	6	1	13	6	7
t11	4	3	5	2	6	1	74	22	52
t12	4	3	5	2	6	1	54	11	43
t13	4	3	5	2	6	1	258	64	194
t21	4	3	5	2	6	1	48	8	40
t22	4	3	5	6	1	2	0	25	-25
t23	4	3	5	6	1	2	0	16	-16
t11	4	3	5	6	1	2	0	28	-28
t12	4	3	5	6	1	2	0	17	-17
t13	4	3	5	6	1	2	0	84	-84
t21	4	3	5	6	1	2	0	213	-213
t22	4	3	5	6	2	1	0	30	-30
t23	4	3	5	6	2	1	0	7	-7
t11	4	3	5	6	2	1	0	28	-28
t12	4	3	5	6	2	1	0	17	-17
t13	4	3	5	6	2	1	0	84	-84
t21	4	3	5	6	2	1	0	213	-213
t22	4	3	6	1	2	5	12	12	0
t23	4	3	6	1	2	5	67	55	12
t11	4	3	6	1	2	5	28	26	2
t12	4	3	6	1	2	5	15	15	0
t13	4	3	6	1	2	5	132	130	2
t21	4	3	6	1	2	5	3	3	0
t22	4	3	6	1	5	2	72	72	0
t23	4	3	6	1	5	2	8	8	0
t11	4	3	6	1	5	2	26	22	4
t12	4	3	6	1	5	2	11	11	0
t13	4	3	6	1	5	2	145	143	2
t21	4	3	6	1	5	2	3	3	0
t22	4	3	6	2	1	5	9	9	0
t23	4	3	6	2	1	5	67	55	12
t11	4	3	6	2	1	5	28	26	2
t12	4	3	6	2	1	5	15	15	0
t13	4	3	6	2	1	5	135	131	4
t21	4	3	6	2	1	5	12	12	0
t22	4	3	6	2	5	1	72	72	0
t23	4	3	6	2	5	1	5	5	0
t11	4	3	6	2	5	1	26	22	4
t12	4	3	6	2	5	1	11	11	0
t13	4	3	6	2	5	1	145	143	2
t21	4	3	6	2	5	1	8	8	0
t22	4	3	6	5	1	2	17	10	7
t23	4	3	6	5	1	2	24	15	9
t11	4	3	6	5	1	2	51	28	23
t12	4	3	6	5	1	2	32	17	15
t13	4	3	6	5	1	2	252	177	75
t21	4	3	6	5	1	2	135	93	42
t22	4	3	6	5	2	1	27	15	12
t23	4	3	6	5	2	1	6	6	0
t11	4	3	6	5	2	1	51	28	23
t12	4	3	6	5	2	1	32	17	15
t13	4	3	6	5	2	1	253	177	76
t21	4	3	6	5	2	1	135	93	42
t22	4	5	1	2	3	6	0	16	-16
t23	4	5	1	2	3	6	0	255	-255
t11	4	5	1	2	3	6	0	26	-26
t12	4	5	1	2	3	6	0	78	-78
t13	4	5	1	2	3	6	0	12	-12
t21	4	5	1	2	3	6	0	7	-7
t22	4	5	1	2	6	3	0	178	-178
t23	4	5	1	2	6	3	0	13	-13
t11	4	5	1	2	6	3	0	22	-22
t12	4	5	1	2	6	3	0	56	-56
t13	4	5	1	2	6	3	0	12	-12
t21	4	5	1	2	6	3	0	7	-7
t22	4	5	1	3	2	6	0	13	-13
t23	4	5	1	3	2	6	0	276	-276
t11	4	5	1	3	2	6	0	26	-26
t12	4	5	1	3	2	6	0	82	-82
t13	4	5	1	3	2	6	0	12	-12
t21	4	5	1	3	2	6	0	16	-16
t22	4	5	1	3	6	2	0	183	-183
t23	4	5	1	3	6	2	0	10	-10
t11	4	5	1	3	6	2	0	22	-22
t12	4	5	1	3	6	2	0	56	-56
t13	4	5	1	3	6	2	0	12	-12
t21	4	5	1	3	6	2	0	12	-12
t22	4	5	1	6	2	3	0	29	-29
t23	4	5	1	6	2	3	0	20	-20
t11	4	5	1	6	2	3	0	28	-28
t12	4	5	1	6	2	3	0	78	-78
t13	4	5	1	6	2	3	0	12	-12
t21	4	5	1	6	2	3	0	213	-213
t22	4	5	1	6	3	2	0	34	-34
t23	4	5	1	6	3	2	0	11	-11
t11	4	5	1	6	3	2	0	28	-28
t12	4	5	1	6	3	2	0	78	-78
t13	4	5	1	6	3	2	0	12	-12
t21	4	5	1	6	3	2	0	213	-213
t22	4	5	2	1	3	6	0	16	-16
t23	4	5	2	1	3	6	0	206	-206
t11	4	5	2	1	3	6	0	26	-26
t12	4	5	2	1	3	6	0	78	-78
t13	4	5	2	1	3	6	0	15	-15
t21	4	5	2	1	3	6	0	3	-3
t22	4	5	2	1	6	3	0	175	-175
t23	4	5	2	1	6	3	0	13	-13
t11	4	5	2	1	6	3	0	22	-22
t12	4	5	2	1	6	3	0	56	-56
t13	4	5	2	1	6	3	0	15	-15
t21	4	5	2	1	6	3	0	3	-3
t22	4	5	2	3	1	6	0	9	-9
t23	4	5	2	3	1	6	0	272	-272
t11	4	5	2	3	1	6	0	26	-26
t12	4	5	2	3	1	6	0	82	-82
t13	4	5	2	3	1	6	0	21	-21
t21	4	5	2	3	1	6	0	16	-16
t22	4	5	2	3	6	1	0	183	-183
t23	4	5	2	3	6	1	0	6	-6
t11	4	5	2	3	6	1	0	22	-22
t12	4	5	2	3	6	1	0	56	-56
t13	4	5	2	3	6	1	0	17	-17
t21	4	5	2	3	6	1	0	12	-12
t22	4	5	2	6	1	3	0	25	-25
t23	4	5	2	6	1	3	0	20	-20
t11	4	5	2	6	1	3	0	28	-28
t12	4	5	2	6	1	3	0	78	-78
t13	4	5	2	6	1	3	0	21	-21
t21	4	5	2	6	1	3	0	213	-213
t22	4	5	2	6	3	1	0	34	-34
t23	4	5	2	6	3	1	0	7	-7
t11	4	5	2	6	3	1	0	28	-28
t12	4	5	2	6	3	1	0	78	-78
t13	4	5	2	6	3	1	0	17	-17
t21	4	5	2	6	3	1	0	213	-213
t22	4	5	3	1	2	6	0	12	-12
t23	4	5	3	1	2	6	0	202	-202
t11	4	5	3	1	2	6	0	26	-26
t12	4	5	3	1	2	6	0	78	-78
t13	4	5	3	1	2	6	0	24	-24
t21	4	5	3	1	2	6	0	3	-3
t22	4	5	3	1	6	2	0	175	-175
t23	4	5	3	1	6	2	0	9	-9
t11	4	5	3	1	6	2	0	22	-22
t12	4	5	3	1	6	2	0	56	-56
t13	4	5	3	1	6	2	0	20	-20
t21	4	5	3	1	6	2	0	3	-3
t22	4	5	3	2	1	6	0	9	-9
t23	4	5	3	2	1	6	0	268	-268
t11	4	5	3	2	1	6	0	26	-26
t12	4	5	3	2	1	6	0	82	-82
t13	4	5	3	2	1	6	0	24	-24
t21	4	5	3	2	1	6	0	12	-12
t22	4	5	3	2	6	1	0	179	-179
t23	4	5	3	2	6	1	0	6	-6
t11	4	5	3	2	6	1	0	22	-22
t12	4	5	3	2	6	1	0	56	-56
t13	4	5	3	2	6	1	0	20	-20
t21	4	5	3	2	6	1	0	8	-8
t22	4	5	3	6	1	2	0	25	-25
t23	4	5	3	6	1	2	0	16	-16
t11	4	5	3	6	1	2	0	28	-28
t12	4	5	3	6	1	2	0	78	-78
t13	4	5	3	6	1	2	0	26	-26
t21	4	5	3	6	1	2	0	213	-213
t22	4	5	3	6	2	1	0	30	-30
t23	4	5	3	6	2	1	0	7	-7
t11	4	5	3	6	2	1	0	28	-28
t12	4	5	3	6	2	1	0	78	-78
t13	4	5	3	6	2	1	0	26	-26
t21	4	5	3	6	2	1	0	213	-213
t22	4	5	6	1	2	3	12	12	0
t23	4	5	6	1	2	3	17	17	0
t11	4	5	6	1	2	3	27	27	0
t12	4	5	6	1	2	3	50	50	0
t13	4	5	6	1	2	3	153	151	2
t21	4	5	6	1	2	3	3	3	0
t22	4	5	6	1	3	2	17	17	0
t23	4	5	6	1	3	2	8	8	0
t11	4	5	6	1	3	2	27	27	0
t12	4	5	6	1	3	2	50	50	0
t13	4	5	6	1	3	2	153	151	2
t21	4	5	6	1	3	2	3	3	0
t22	4	5	6	2	1	3	9	9	0
t23	4	5	6	2	1	3	17	17	0
t11	4	5	6	2	1	3	27	27	0
t12	4	5	6	2	1	3	50	50	0
t13	4	5	6	2	1	3	167	167	0
t21	4	5	6	2	1	3	12	12	0
t22	4	5	6	2	3	1	17	17	0
t23	4	5	6	2	3	1	5	5	0
t11	4	5	6	2	3	1	27	27	0
t12	4	5	6	2	3	1	50	50	0
t13	4	5	6	2	3	1	167	151	16
t21	4	5	6	2	3	1	8	8	0
t22	4	5	6	3	1	2	9	9	0
t23	4	5	6	3	1	2	14	14	0
t11	4	5	6	3	1	2	27	27	0
t12	4	5	6	3	1	2	50	50	0
t13	4	5	6	3	1	2	167	167	0
t21	4	5	6	3	1	2	17	17	0
t22	4	5	6	3	2	1	14	14	0
t23	4	5	6	3	2	1	5	5	0
t11	4	5	6	3	2	1	27	27	0
t12	4	5	6	3	2	1	50	50	0
t13	4	5	6	3	2	1	167	167	0
t21	4	5	6	3	2	1	17	17	0
t22	4	6	1	2	3	5	0	16	-16
t23	4	6	1	2	3	5	0	51	-51
t11	4	6	1	2	3	5	0	26	-26
t12	4	6	1	2	3	5	0	102	-102
t13	4	6	1	2	3	5	0	14	-14
t21	4	6	1	2	3	5	0	7	-7
t22	4	6	1	2	5	3	0	66	-66
t23	4	6	1	2	5	3	0	12	-12
t11	4	6	1	2	5	3	0	22	-22
t12	4	6	1	2	5	3	0	99	-99
t13	4	6	1	2	5	3	0	14	-14
t21	4	6	1	2	5	3	0	7	-7
t22	4	6	1	3	2	5	0	13	-13
t23	4	6	1	3	2	5	0	51	-51
t11	4	6	1	3	2	5	0	26	-26
t12	4	6	1	3	2	5	0	116	-116
t13	4	6	1	3	2	5	0	16	-16
t21	4	6	1	3	2	5	0	16	-16
t22	4	6	1	3	5	2	0	66	-66
t23	4	6	1	3	5	2	0	9	-9
t11	4	6	1	3	5	2	0	22	-22
t12	4	6	1	3	5	2	0	113	-113
t13	4	6	1	3	5	2	0	16	-16
t21	4	6	1	3	5	2	0	12	-12
t22	4	6	1	5	2	3	0	13	-13
t23	4	6	1	5	2	3	0	18	-18
t11	4	6	1	5	2	3	0	28	-28
t12	4	6	1	5	2	3	0	142	-142
t13	4	6	1	5	2	3	0	18	-18
t21	4	6	1	5	2	3	0	75	-75
t22	4	6	1	5	3	2	0	18	-18
t23	4	6	1	5	3	2	0	9	-9
t11	4	6	1	5	3	2	0	28	-28
t12	4	6	1	5	3	2	0	142	-142
t13	4	6	1	5	3	2	0	18	-18
t21	4	6	1	5	3	2	0	75	-75
t22	4	6	2	1	3	5	0	16	-16
t23	4	6	2	1	3	5	0	51	-51
t11	4	6	2	1	3	5	0	26	-26
t12	4	6	2	1	3	5	0	102	-102
t13	4	6	2	1	3	5	0	17	-17
t21	4	6	2	1	3	5	0	3	-3
t22	4	6	2	1	5	3	0	51	-51
t23	4	6	2	1	5	3	0	12	-12
t11	4	6	2	1	5	3	0	22	-22
t12	4	6	2	1	5	3	0	98	-98
t13	4	6	2	1	5	3	0	17	-17
t21	4	6	2	1	5	3	0	3	-3
t22	4	6	2	3	1	5	0	9	-9
t23	4	6	2	3	1	5	0	51	-51
t11	4	6	2	3	1	5	0	26	-26
t12	4	6	2	3	1	5	0	116	-116
t13	4	6	2	3	1	5	0	25	-25
t21	4	6	2	3	1	5	0	16	-16
t22	4	6	2	3	5	1	0	66	-66
t23	4	6	2	3	5	1	0	5	-5
t11	4	6	2	3	5	1	0	22	-22
t12	4	6	2	3	5	1	0	113	-113
t13	4	6	2	3	5	1	0	21	-21
t21	4	6	2	3	5	1	0	12	-12
t22	4	6	2	5	1	3	0	9	-9
t23	4	6	2	5	1	3	0	18	-18
t11	4	6	2	5	1	3	0	28	-28
t12	4	6	2	5	1	3	0	142	-142
t13	4	6	2	5	1	3	0	27	-27
t21	4	6	2	5	1	3	0	75	-75
t22	4	6	2	5	3	1	0	18	-18
t23	4	6	2	5	3	1	0	5	-5
t11	4	6	2	5	3	1	0	28	-28
t12	4	6	2	5	3	1	0	142	-142
t13	4	6	2	5	3	1	0	23	-23
t21	4	6	2	5	3	1	0	75	-75
t22	4	6	3	1	2	5	0	12	-12
t23	4	6	3	1	2	5	0	51	-51
t11	4	6	3	1	2	5	0	26	-26
t12	4	6	3	1	2	5	0	102	-102
t13	4	6	3	1	2	5	0	26	-26
t21	4	6	3	1	2	5	0	3	-3
t22	4	6	3	1	5	2	0	51	-51
t23	4	6	3	1	5	2	0	8	-8
t11	4	6	3	1	5	2	0	22	-22
t12	4	6	3	1	5	2	0	98	-98
t13	4	6	3	1	5	2	0	22	-22
t21	4	6	3	1	5	2	0	3	-3
t22	4	6	3	2	1	5	0	9	-9
t23	4	6	3	2	1	5	0	51	-51
t11	4	6	3	2	1	5	0	26	-26
t12	4	6	3	2	1	5	0	116	-116
t13	4	6	3	2	1	5	0	28	-28
t21	4	6	3	2	1	5	0	12	-12
t22	4	6	3	2	5	1	0	66	-66
t23	4	6	3	2	5	1	0	5	-5
t11	4	6	3	2	5	1	0	22	-22
t12	4	6	3	2	5	1	0	113	-113
t13	4	6	3	2	5	1	0	24	-24
t21	4	6	3	2	5	1	0	8	-8
t22	4	6	3	5	1	2	0	9	-9
t23	4	6	3	5	1	2	0	14	-14
t11	4	6	3	5	1	2	0	28	-28
t12	4	6	3	5	1	2	0	142	-142
t13	4	6	3	5	1	2	0	32	-32
t21	4	6	3	5	1	2	0	75	-75
t22	4	6	3	5	2	1	0	14	-14
t23	4	6	3	5	2	1	0	5	-5
t11	4	6	3	5	2	1	0	28	-28
t12	4	6	3	5	2	1	0	142	-142
t13	4	6	3	5	2	1	0	32	-32
t21	4	6	3	5	2	1	0	75	-75
t22	4	6	5	1	2	3	0	12	-12
t23	4	6	5	1	2	3	0	17	-17
t11	4	6	5	1	2	3	0	27	-27
t12	4	6	5	1	2	3	0	103	-103
t13	4	6	5	1	2	3	0	118	-118
t21	4	6	5	1	2	3	0	3	-3
t22	4	6	5	1	3	2	0	17	-17
t23	4	6	5	1	3	2	0	8	-8
t11	4	6	5	1	3	2	0	27	-27
t12	4	6	5	1	3	2	0	103	-103
t13	4	6	5	1	3	2	0	118	-118
t21	4	6	5	1	3	2	0	3	-3
t22	4	6	5	2	1	3	0	9	-9
t23	4	6	5	2	1	3	0	17	-17
t11	4	6	5	2	1	3	0	27	-27
t12	4	6	5	2	1	3	0	117	-117
t13	4	6	5	2	1	3	0	121	-121
t21	4	6	5	2	1	3	0	12	-12
t22	4	6	5	2	3	1	0	17	-17
t23	4	6	5	2	3	1	0	5	-5
t11	4	6	5	2	3	1	0	27	-27
t12	4	6	5	2	3	1	0	117	-117
t13	4	6	5	2	3	1	0	121	-121
t21	4	6	5	2	3	1	0	8	-8
t22	4	6	5	3	1	2	0	9	-9
t23	4	6	5	3	1	2	0	14	-14
t11	4	6	5	3	1	2	0	27	-27
t12	4	6	5	3	1	2	0	117	-117
t13	4	6	5	3	1	2	0	121	-121
t21	4	6	5	3	1	2	0	17	-17
t22	4	6	5	3	2	1	0	14	-14
t23	4	6	5	3	2	1	0	5	-5
t11	4	6	5	3	2	1	0	27	-27
t12	4	6	5	3	2	1	0	117	-117
t13	4	6	5	3	2	1	0	121	-121
t21	4	6	5	3	2	1	0	17	-17
t22	5	1	2	3	4	6	60	18	42
t23	5	1	2	3	4	6	626	255	371
t11	5	1	2	3	4	6	89	35	54
t12	5	1	2	3	4	6	6	4	2
t13	5	1	2	3	4	6	27	10	17
t21	5	1	2	3	4	6	45	9	36
t22	5	1	2	3	6	4	2209	180	2029
t23	5	1	2	3	6	4	274	15	259
t11	5	1	2	3	6	4	401	31	370
t12	5	1	2	3	6	4	23	3	20
t13	5	1	2	3	6	4	104	8	96
t21	5	1	2	3	6	4	177	9	168
t22	5	1	2	4	3	6	51	15	36
t23	5	1	2	4	3	6	626	280	346
t11	5	1	2	4	3	6	89	35	54
t12	5	1	2	4	3	6	6	4	2
t13	5	1	2	4	3	6	27	10	17
t21	5	1	2	4	3	6	69	18	51
t22	5	1	2	4	6	3	5781	185	5596
t23	5	1	2	4	6	3	625	12	613
t11	5	1	2	4	6	3	983	31	952
t12	5	1	2	4	6	3	53	3	50
t13	5	1	2	4	6	3	246	8	238
t21	5	1	2	4	6	3	929	14	915
t22	5	1	2	6	3	4	0	31	-31
t23	5	1	2	6	3	4	0	22	-22
t11	5	1	2	6	3	4	0	37	-37
t12	5	1	2	6	3	4	0	4	-4
t13	5	1	2	6	3	4	0	10	-10
t21	5	1	2	6	3	4	0	213	-213
t22	5	1	2	6	4	3	0	36	-36
t23	5	1	2	6	4	3	0	13	-13
t11	5	1	2	6	4	3	0	37	-37
t12	5	1	2	6	4	3	0	4	-4
t13	5	1	2	6	4	3	0	10	-10
t21	5	1	2	6	4	3	0	213	-213
t22	5	1	3	2	4	6	48	18	30
t23	5	1	3	2	4	6	426	210	216
t11	5	1	3	2	4	6	63	35	28
t12	5	1	3	2	4	6	5	4	1
t13	5	1	3	2	4	6	23	13	10
t21	5	1	3	2	4	6	11	5	6
t22	5	1	3	2	6	4	1466	176	1290
t23	5	1	3	2	6	4	191	15	176
t11	5	1	3	2	6	4	278	31	247
t12	5	1	3	2	6	4	16	3	13
t13	5	1	3	2	6	4	80	11	69
t21	5	1	3	2	6	4	35	5	30
t22	5	1	3	4	2	6	21	11	10
t23	5	1	3	4	2	6	615	276	339
t11	5	1	3	4	2	6	89	35	54
t12	5	1	3	4	2	6	6	4	2
t13	5	1	3	4	2	6	47	19	28
t21	5	1	3	4	2	6	69	18	51
t22	5	1	3	4	6	2	5781	185	5596
t23	5	1	3	4	6	2	213	8	205
t11	5	1	3	4	6	2	983	31	952
t12	5	1	3	4	6	2	53	3	50
t13	5	1	3	4	6	2	624	13	611
t21	5	1	3	4	6	2	929	14	915
t22	5	1	3	6	2	4	0	27	-27
t23	5	1	3	6	2	4	0	22	-22
t11	5	1	3	6	2	4	0	37	-37
t12	5	1	3	6	2	4	0	4	-4
t13	5	1	3	6	2	4	0	19	-19
t21	5	1	3	6	2	4	0	213	-213
t22	5	1	3	6	4	2	0	36	-36
t23	5	1	3	6	4	2	0	9	-9
t11	5	1	3	6	4	2	0	37	-37
t12	5	1	3	6	4	2	0	4	-4
t13	5	1	3	6	4	2	0	15	-15
t21	5	1	3	6	4	2	0	213	-213
t22	5	1	4	2	3	6	22	14	8
t23	5	1	4	2	3	6	400	206	194
t11	5	1	4	2	3	6	63	35	28
t12	5	1	4	2	3	6	5	4	1
t13	5	1	4	2	3	6	32	22	10
t21	5	1	4	2	3	6	11	5	6
t22	5	1	4	2	6	3	1466	176	1290
t23	5	1	4	2	6	3	68	11	57
t11	5	1	4	2	6	3	278	31	247
t12	5	1	4	2	6	3	16	3	13
t13	5	1	4	2	6	3	178	16	162
t21	5	1	4	2	6	3	35	5	30
t22	5	1	4	3	2	6	19	11	8
t23	5	1	4	3	2	6	492	272	220
t11	5	1	4	3	2	6	80	35	45
t12	5	1	4	3	2	6	6	4	2
t13	5	1	4	3	2	6	38	22	16
t21	5	1	4	3	2	6	24	14	10
t22	5	1	4	3	6	2	2220	181	2039
t23	5	1	4	3	6	2	86	8	78
t11	5	1	4	3	6	2	401	31	370
t12	5	1	4	3	6	2	23	3	20
t13	5	1	4	3	6	2	262	16	246
t21	5	1	4	3	6	2	188	10	178
t22	5	1	4	6	2	3	0	27	-27
t23	5	1	4	6	2	3	0	18	-18
t11	5	1	4	6	2	3	0	37	-37
t12	5	1	4	6	2	3	0	4	-4
t13	5	1	4	6	2	3	0	24	-24
t21	5	1	4	6	2	3	0	213	-213
t22	5	1	4	6	3	2	0	32	-32
t23	5	1	4	6	3	2	0	9	-9
t11	5	1	4	6	3	2	0	37	-37
t12	5	1	4	6	3	2	0	4	-4
t13	5	1	4	6	3	2	0	24	-24
t21	5	1	4	6	3	2	0	213	-213
t22	5	1	6	2	3	4	18	14	4
t23	5	1	6	2	3	4	25	19	6
t11	5	1	6	2	3	4	35	31	4
t12	5	1	6	2	3	4	4	3	1
t13	5	1	6	2	3	4	130	127	3
t21	5	1	6	2	3	4	9	5	4
t22	5	1	6	2	4	3	25	19	6
t23	5	1	6	2	4	3	14	10	4
t11	5	1	6	2	4	3	35	31	4
t12	5	1	6	2	4	3	4	3	1
t13	5	1	6	2	4	3	130	127	3
t21	5	1	6	2	4	3	9	5	4
t22	5	1	6	3	2	4	15	11	4
t23	5	1	6	3	2	4	25	19	6
t11	5	1	6	3	2	4	35	31	4
t12	5	1	6	3	2	4	4	3	1
t13	5	1	6	3	2	4	134	127	7
t21	5	1	6	3	2	4	18	14	4
t22	5	1	6	3	4	2	25	19	6
t23	5	1	6	3	4	2	11	7	4
t11	5	1	6	3	4	2	35	31	4
t12	5	1	6	3	4	2	4	3	1
t13	5	1	6	3	4	2	134	127	7
t21	5	1	6	3	4	2	14	10	4
t22	5	1	6	4	2	3	15	11	4
t23	5	1	6	4	2	3	20	16	4
t11	5	1	6	4	2	3	35	31	4
t12	5	1	6	4	2	3	4	3	1
t13	5	1	6	4	2	3	134	127	7
t21	5	1	6	4	2	3	25	19	6
t22	5	1	6	4	3	2	20	16	4
t23	5	1	6	4	3	2	11	7	4
t11	5	1	6	4	3	2	35	31	4
t12	5	1	6	4	3	2	4	3	1
t13	5	1	6	4	3	2	134	128	6
t21	5	1	6	4	3	2	25	19	6
t22	5	2	1	3	4	6	86	18	68
t23	5	2	1	3	4	6	871	255	616
t11	5	2	1	3	4	6	120	35	85
t12	5	2	1	3	4	6	56	8	48
t13	5	2	1	3	4	6	22	8	14
t21	5	2	1	3	4	6	71	9	62
t22	5	2	1	3	6	4	0	180	-180
t23	5	2	1	3	6	4	0	15	-15
t11	5	2	1	3	6	4	0	31	-31
t12	5	2	1	3	6	4	0	7	-7
t13	5	2	1	3	6	4	0	8	-8
t21	5	2	1	3	6	4	0	9	-9
t22	5	2	1	4	3	6	107	15	92
t23	5	2	1	4	3	6	1066	280	786
t11	5	2	1	4	3	6	143	35	108
t12	5	2	1	4	3	6	65	8	57
t13	5	2	1	4	3	6	25	8	17
t21	5	2	1	4	3	6	122	18	104
t22	5	2	1	4	6	3	0	185	-185
t23	5	2	1	4	6	3	0	12	-12
t11	5	2	1	4	6	3	0	31	-31
t12	5	2	1	4	6	3	0	7	-7
t13	5	2	1	4	6	3	0	8	-8
t21	5	2	1	4	6	3	0	14	-14
t22	5	2	1	6	3	4	0	31	-31
t23	5	2	1	6	3	4	0	22	-22
t11	5	2	1	6	3	4	0	37	-37
t12	5	2	1	6	3	4	0	8	-8
t13	5	2	1	6	3	4	0	8	-8
t21	5	2	1	6	3	4	0	213	-213
t22	5	2	1	6	4	3	0	36	-36
t23	5	2	1	6	4	3	0	13	-13
t11	5	2	1	6	4	3	0	37	-37
t12	5	2	1	6	4	3	0	8	-8
t13	5	2	1	6	4	3	0	8	-8
t21	5	2	1	6	4	3	0	213	-213
t22	5	2	3	1	4	6	48	18	30
t23	5	2	3	1	4	6	467	208	259
t11	5	2	3	1	4	6	69	35	34
t12	5	2	3	1	4	6	8	7	1
t13	5	2	3	1	4	6	26	13	13
t21	5	2	3	1	4	6	3	3	0
t22	5	2	3	1	6	4	1395	175	1220
t23	5	2	3	1	6	4	184	15	169
t11	5	2	3	1	6	4	267	31	236
t12	5	2	3	1	6	4	19	6	13
t13	5	2	3	1	6	4	78	13	65
t21	5	2	3	1	6	4	3	3	0
t22	5	2	3	4	1	6	9	9	0
t23	5	2	3	4	1	6	672	274	398
t11	5	2	3	4	1	6	96	35	61
t12	5	2	3	4	1	6	16	13	3
t13	5	2	3	4	1	6	48	19	29
t21	5	2	3	4	1	6	75	18	57
t22	5	2	3	4	6	1	0	185	-185
t23	5	2	3	4	6	1	0	6	-6
t11	5	2	3	4	6	1	0	31	-31
t12	5	2	3	4	6	1	0	8	-8
t13	5	2	3	4	6	1	0	15	-15
t21	5	2	3	4	6	1	0	14	-14
t22	5	2	3	6	1	4	0	25	-25
t23	5	2	3	6	1	4	0	22	-22
t11	5	2	3	6	1	4	0	37	-37
t12	5	2	3	6	1	4	0	13	-13
t13	5	2	3	6	1	4	0	19	-19
t21	5	2	3	6	1	4	0	213	-213
t22	5	2	3	6	4	1	0	36	-36
t23	5	2	3	6	4	1	0	7	-7
t11	5	2	3	6	4	1	0	37	-37
t12	5	2	3	6	4	1	0	9	-9
t13	5	2	3	6	4	1	0	15	-15
t21	5	2	3	6	4	1	0	213	-213
t22	5	2	4	1	3	6	22	14	8
t23	5	2	4	1	3	6	467	204	263
t11	5	2	4	1	3	6	69	35	34
t12	5	2	4	1	3	6	8	7	1
t13	5	2	4	1	3	6	35	22	13
t21	5	2	4	1	3	6	3	3	0
t22	5	2	4	1	6	3	1395	175	1220
t23	5	2	4	1	6	3	65	11	54
t11	5	2	4	1	6	3	267	31	236
t12	5	2	4	1	6	3	19	6	13
t13	5	2	4	1	6	3	168	18	150
t21	5	2	4	1	6	3	3	3	0
t22	5	2	4	3	1	6	9	9	0
t23	5	2	4	3	1	6	580	270	310
t11	5	2	4	3	1	6	93	35	58
t12	5	2	4	3	1	6	15	13	2
t13	5	2	4	3	1	6	42	22	20
t21	5	2	4	3	1	6	24	14	10
t22	5	2	4	3	6	1	0	181	-181
t23	5	2	4	3	6	1	0	6	-6
t11	5	2	4	3	6	1	0	31	-31
t12	5	2	4	3	6	1	0	8	-8
t13	5	2	4	3	6	1	0	18	-18
t21	5	2	4	3	6	1	0	10	-10
t22	5	2	4	6	1	3	0	25	-25
t23	5	2	4	6	1	3	0	18	-18
t11	5	2	4	6	1	3	0	37	-37
t12	5	2	4	6	1	3	0	13	-13
t13	5	2	4	6	1	3	0	24	-24
t21	5	2	4	6	1	3	0	213	-213
t22	5	2	4	6	3	1	0	32	-32
t23	5	2	4	6	3	1	0	7	-7
t11	5	2	4	6	3	1	0	37	-37
t12	5	2	4	6	3	1	0	9	-9
t13	5	2	4	6	3	1	0	24	-24
t21	5	2	4	6	3	1	0	213	-213
t22	5	2	6	1	3	4	18	14	4
t23	5	2	6	1	3	4	25	19	6
t11	5	2	6	1	3	4	35	31	4
t12	5	2	6	1	3	4	7	6	1
t13	5	2	6	1	3	4	132	128	4
t21	5	2	6	1	3	4	3	3	0
t22	5	2	6	1	4	3	25	19	6
t23	5	2	6	1	4	3	14	10	4
t11	5	2	6	1	4	3	35	31	4
t12	5	2	6	1	4	3	7	6	1
t13	5	2	6	1	4	3	132	128	4
t21	5	2	6	1	4	3	3	3	0
t22	5	2	6	3	1	4	9	9	0
t23	5	2	6	3	1	4	25	19	6
t11	5	2	6	3	1	4	35	31	4
t12	5	2	6	3	1	4	13	12	1
t13	5	2	6	3	1	4	139	133	6
t21	5	2	6	3	1	4	18	14	4
t22	5	2	6	3	4	1	25	19	6
t23	5	2	6	3	4	1	5	5	0
t11	5	2	6	3	4	1	35	31	4
t12	5	2	6	3	4	1	9	8	1
t13	5	2	6	3	4	1	139	129	10
t21	5	2	6	3	4	1	14	10	4
t22	5	2	6	4	1	3	9	9	0
t23	5	2	6	4	1	3	20	16	4
t11	5	2	6	4	1	3	35	31	4
t12	5	2	6	4	1	3	13	12	1
t13	5	2	6	4	1	3	143	133	10
t21	5	2	6	4	1	3	25	19	6
t22	5	2	6	4	3	1	20	16	4
t23	5	2	6	4	3	1	5	5	0
t11	5	2	6	4	3	1	35	31	4
t12	5	2	6	4	3	1	9	8	1
t13	5	2	6	4	3	1	139	133	6
t21	5	2	6	4	3	1	25	19	6
t22	5	3	1	2	4	6	86	18	68
t23	5	3	1	2	4	6	843	255	588
t11	5	3	1	2	4	6	116	35	81
t12	5	3	1	2	4	6	59	11	48
t13	5	3	1	2	4	6	22	8	14
t21	5	3	1	2	4	6	47	7	40
t22	5	3	1	2	6	4	0	178	-178
t23	5	3	1	2	6	4	0	15	-15
t11	5	3	1	2	6	4	0	31	-31
t12	5	3	1	2	6	4	0	10	-10
t13	5	3	1	2	6	4	0	8	-8
t21	5	3	1	2	6	4	0	7	-7
t22	5	3	1	4	2	6	101	13	88
t23	5	3	1	4	2	6	1547	278	1269
t11	5	3	1	4	2	6	197	35	162
t12	5	3	1	4	2	6	140	17	123
t13	5	3	1	4	2	6	38	8	30
t21	5	3	1	4	2	6	173	18	155
t22	5	3	1	4	6	2	0	185	-185
t23	5	3	1	4	6	2	0	10	-10
t11	5	3	1	4	6	2	0	31	-31
t12	5	3	1	4	6	2	0	12	-12
t13	5	3	1	4	6	2	0	8	-8
t21	5	3	1	4	6	2	0	14	-14
t22	5	3	1	6	2	4	0	29	-29
t23	5	3	1	6	2	4	0	22	-22
t11	5	3	1	6	2	4	0	37	-37
t12	5	3	1	6	2	4	0	17	-17
t13	5	3	1	6	2	4	0	9	-9
t21	5	3	1	6	2	4	0	213	-213
t22	5	3	1	6	4	2	0	36	-36
t23	5	3	1	6	4	2	0	11	-11
t11	5	3	1	6	4	2	0	37	-37
t12	5	3	1	6	4	2	0	13	-13
t13	5	3	1	6	4	2	0	8	-8
t21	5	3	1	6	4	2	0	213	-213
t22	5	3	2	1	4	6	80	18	62
t23	5	3	2	1	4	6	746	208	538
t11	5	3	2	1	4	6	109	35	74
t12	5	3	2	1	4	6	54	11	43
t13	5	3	2	1	4	6	23	11	12
t21	5	3	2	1	4	6	3	3	0
t22	5	3	2	1	6	4	0	175	-175
t23	5	3	2	1	6	4	0	15	-15
t11	5	3	2	1	6	4	0	31	-31
t12	5	3	2	1	6	4	0	10	-10
t13	5	3	2	1	6	4	0	11	-11
t21	5	3	2	1	6	4	0	3	-3
t22	5	3	2	4	1	6	17	9	8
t23	5	3	2	4	1	6	1470	274	1196
t11	5	3	2	4	1	6	197	35	162
t12	5	3	2	4	1	6	140	17	123
t13	5	3	2	4	1	6	65	17	48
t21	5	3	2	4	1	6	173	18	155
t22	5	3	2	4	6	1	0	185	-185
t23	5	3	2	4	6	1	0	6	-6
t11	5	3	2	4	6	1	0	31	-31
t12	5	3	2	4	6	1	0	12	-12
t13	5	3	2	4	6	1	0	13	-13
t21	5	3	2	4	6	1	0	14	-14
t22	5	3	2	6	1	4	0	25	-25
t23	5	3	2	6	1	4	0	22	-22
t11	5	3	2	6	1	4	0	37	-37
t12	5	3	2	6	1	4	0	17	-17
t13	5	3	2	6	1	4	0	18	-18
t21	5	3	2	6	1	4	0	213	-213
t22	5	3	2	6	4	1	0	36	-36
t23	5	3	2	6	4	1	0	7	-7
t11	5	3	2	6	4	1	0	37	-37
t12	5	3	2	6	4	1	0	13	-13
t13	5	3	2	6	4	1	0	13	-13
t21	5	3	2	6	4	1	0	213	-213
t22	5	3	4	1	2	6	12	12	0
t23	5	3	4	1	2	6	473	202	271
t11	5	3	4	1	2	6	73	35	38
t12	5	3	4	1	2	6	17	16	1
t13	5	3	4	1	2	6	36	22	14
t21	5	3	4	1	2	6	3	3	0
t22	5	3	4	1	6	2	15393	175	15218
t23	5	3	4	1	6	2	192	9	183
t11	5	3	4	1	6	2	2981	31	2950
t12	5	3	4	1	6	2	1024	11	1013
t13	5	3	4	1	6	2	1924	18	1906
t21	5	3	4	1	6	2	3	3	0
t22	5	3	4	2	1	6	9	9	0
t23	5	3	4	2	1	6	553	268	285
t11	5	3	4	2	1	6	83	35	48
t12	5	3	4	2	1	6	18	16	2
t13	5	3	4	2	1	6	40	22	18
t21	5	3	4	2	1	6	12	12	0
t22	5	3	4	2	6	1	0	179	-179
t23	5	3	4	2	6	1	0	6	-6
t11	5	3	4	2	6	1	0	31	-31
t12	5	3	4	2	6	1	0	11	-11
t13	5	3	4	2	6	1	0	18	-18
t21	5	3	4	2	6	1	0	8	-8
t22	5	3	4	6	1	2	0	25	-25
t23	5	3	4	6	1	2	0	16	-16
t11	5	3	4	6	1	2	0	37	-37
t12	5	3	4	6	1	2	0	18	-18
t13	5	3	4	6	1	2	0	26	-26
t21	5	3	4	6	1	2	0	213	-213
t22	5	3	4	6	2	1	0	30	-30
t23	5	3	4	6	2	1	0	7	-7
t11	5	3	4	6	2	1	0	37	-37
t12	5	3	4	6	2	1	0	18	-18
t13	5	3	4	6	2	1	0	26	-26
t21	5	3	4	6	2	1	0	213	-213
t22	5	3	6	1	2	4	12	12	0
t23	5	3	6	1	2	4	25	19	6
t11	5	3	6	1	2	4	35	31	4
t12	5	3	6	1	2	4	16	15	1
t13	5	3	6	1	2	4	141	135	6
t21	5	3	6	1	2	4	3	3	0
t22	5	3	6	1	4	2	25	19	6
t23	5	3	6	1	4	2	8	8	0
t11	5	3	6	1	4	2	35	31	4
t12	5	3	6	1	4	2	12	11	1
t13	5	3	6	1	4	2	137	131	6
t21	5	3	6	1	4	2	3	3	0
t22	5	3	6	2	1	4	9	9	0
t23	5	3	6	2	1	4	25	19	6
t11	5	3	6	2	1	4	35	31	4
t12	5	3	6	2	1	4	16	15	1
t13	5	3	6	2	1	4	142	136	6
t21	5	3	6	2	1	4	12	12	0
t22	5	3	6	2	4	1	25	19	6
t23	5	3	6	2	4	1	5	5	0
t11	5	3	6	2	4	1	35	31	4
t12	5	3	6	2	4	1	12	11	1
t13	5	3	6	2	4	1	138	131	7
t21	5	3	6	2	4	1	8	8	0
t22	5	3	6	4	1	2	9	9	0
t23	5	3	6	4	1	2	14	14	0
t11	5	3	6	4	1	2	35	31	4
t12	5	3	6	4	1	2	18	17	1
t13	5	3	6	4	1	2	148	138	10
t21	5	3	6	4	1	2	25	19	6
t22	5	3	6	4	2	1	14	14	0
t23	5	3	6	4	2	1	5	5	0
t11	5	3	6	4	2	1	35	31	4
t12	5	3	6	4	2	1	18	17	1
t13	5	3	6	4	2	1	148	138	10
t21	5	3	6	4	2	1	25	19	6
t22	5	4	1	2	3	6	80	16	64
t23	5	4	1	2	3	6	1171	255	916
t11	5	4	1	2	3	6	161	35	126
t12	5	4	1	2	3	6	110	20	90
t13	5	4	1	2	3	6	32	10	22
t21	5	4	1	2	3	6	71	7	64
t22	5	4	1	2	6	3	0	178	-178
t23	5	4	1	2	6	3	0	13	-13
t11	5	4	1	2	6	3	0	31	-31
t12	5	4	1	2	6	3	0	15	-15
t13	5	4	1	2	6	3	0	8	-8
t21	5	4	1	2	6	3	0	7	-7
t22	5	4	1	3	2	6	82	13	69
t23	5	4	1	3	2	6	1237	276	961
t11	5	4	1	3	2	6	166	35	131
t12	5	4	1	3	2	6	123	20	103
t13	5	4	1	3	2	6	32	10	22
t21	5	4	1	3	2	6	93	16	77
t22	5	4	1	3	6	2	0	183	-183
t23	5	4	1	3	6	2	0	10	-10
t11	5	4	1	3	6	2	0	31	-31
t12	5	4	1	3	6	2	0	15	-15
t13	5	4	1	3	6	2	0	8	-8
t21	5	4	1	3	6	2	0	12	-12
t22	5	4	1	6	2	3	0	29	-29
t23	5	4	1	6	2	3	0	20	-20
t11	5	4	1	6	2	3	0	37	-37
t12	5	4	1	6	2	3	0	22	-22
t13	5	4	1	6	2	3	0	10	-10
t21	5	4	1	6	2	3	0	213	-213
t22	5	4	1	6	3	2	0	34	-34
t23	5	4	1	6	3	2	0	11	-11
t11	5	4	1	6	3	2	0	37	-37
t12	5	4	1	6	3	2	0	22	-22
t13	5	4	1	6	3	2	0	10	-10
t21	5	4	1	6	3	2	0	213	-213
t22	5	4	2	1	3	6	64	16	48
t23	5	4	2	1	3	6	848	206	642
t11	5	4	2	1	3	6	125	35	90
t12	5	4	2	1	3	6	76	20	56
t13	5	4	2	1	3	6	27	13	14
t21	5	4	2	1	3	6	3	3	0
t22	5	4	2	1	6	3	0	175	-175
t23	5	4	2	1	6	3	0	13	-13
t11	5	4	2	1	6	3	0	31	-31
t12	5	4	2	1	6	3	0	15	-15
t13	5	4	2	1	6	3	0	11	-11
t21	5	4	2	1	6	3	0	3	-3
t22	5	4	2	3	1	6	10	9	1
t23	5	4	2	3	1	6	1171	272	899
t11	5	4	2	3	1	6	166	35	131
t12	5	4	2	3	1	6	123	20	103
t13	5	4	2	3	1	6	50	19	31
t21	5	4	2	3	1	6	93	16	77
t22	5	4	2	3	6	1	0	183	-183
t23	5	4	2	3	6	1	0	6	-6
t11	5	4	2	3	6	1	0	31	-31
t12	5	4	2	3	6	1	0	15	-15
t13	5	4	2	3	6	1	0	13	-13
t21	5	4	2	3	6	1	0	12	-12
t22	5	4	2	6	1	3	0	25	-25
t23	5	4	2	6	1	3	0	20	-20
t11	5	4	2	6	1	3	0	37	-37
t12	5	4	2	6	1	3	0	22	-22
t13	5	4	2	6	1	3	0	19	-19
t21	5	4	2	6	1	3	0	213	-213
t22	5	4	2	6	3	1	0	34	-34
t23	5	4	2	6	3	1	0	7	-7
t11	5	4	2	6	3	1	0	37	-37
t12	5	4	2	6	3	1	0	22	-22
t13	5	4	2	6	3	1	0	15	-15
t21	5	4	2	6	3	1	0	213	-213
t22	5	4	3	1	2	6	12	12	0
t23	5	4	3	1	2	6	796	202	594
t11	5	4	3	1	2	6	125	35	90
t12	5	4	3	1	2	6	76	20	56
t13	5	4	3	1	2	6	36	22	14
t21	5	4	3	1	2	6	3	3	0
t22	5	4	3	1	6	2	0	175	-175
t23	5	4	3	1	6	2	0	9	-9
t11	5	4	3	1	6	2	0	31	-31
t12	5	4	3	1	6	2	0	15	-15
t13	5	4	3	1	6	2	0	16	-16
t21	5	4	3	1	6	2	0	3	-3
t22	5	4	3	2	1	6	9	9	0
t23	5	4	3	2	1	6	855	268	587
t11	5	4	3	2	1	6	125	35	90
t12	5	4	3	2	1	6	76	20	56
t13	5	4	3	2	1	6	36	22	14
t21	5	4	3	2	1	6	12	12	0
t22	5	4	3	2	6	1	0	179	-179
t23	5	4	3	2	6	1	0	6	-6
t11	5	4	3	2	6	1	0	31	-31
t12	5	4	3	2	6	1	0	15	-15
t13	5	4	3	2	6	1	0	16	-16
t21	5	4	3	2	6	1	0	8	-8
t22	5	4	3	6	1	2	0	25	-25
t23	5	4	3	6	1	2	0	16	-16
t11	5	4	3	6	1	2	0	37	-37
t12	5	4	3	6	1	2	0	22	-22
t13	5	4	3	6	1	2	0	24	-24
t21	5	4	3	6	1	2	0	213	-213
t22	5	4	3	6	2	1	0	30	-30
t23	5	4	3	6	2	1	0	7	-7
t11	5	4	3	6	2	1	0	37	-37
t12	5	4	3	6	2	1	0	22	-22
t13	5	4	3	6	2	1	0	24	-24
t21	5	4	3	6	2	1	0	213	-213
t22	5	4	6	1	2	3	12	12	0
t23	5	4	6	1	2	3	17	17	0
t11	5	4	6	1	2	3	35	31	4
t12	5	4	6	1	2	3	21	20	1
t13	5	4	6	1	2	3	144	140	4
t21	5	4	6	1	2	3	3	3	0
t22	5	4	6	1	3	2	17	17	0
t23	5	4	6	1	3	2	8	8	0
t11	5	4	6	1	3	2	35	31	4
t12	5	4	6	1	3	2	21	20	1
t13	5	4	6	1	3	2	144	140	4
t21	5	4	6	1	3	2	3	3	0
t22	5	4	6	2	1	3	9	9	0
t23	5	4	6	2	1	3	17	17	0
t11	5	4	6	2	1	3	35	31	4
t12	5	4	6	2	1	3	21	20	1
t13	5	4	6	2	1	3	147	141	6
t21	5	4	6	2	1	3	12	12	0
t22	5	4	6	2	3	1	17	17	0
t23	5	4	6	2	3	1	5	5	0
t11	5	4	6	2	3	1	35	31	4
t12	5	4	6	2	3	1	21	20	1
t13	5	4	6	2	3	1	147	140	7
t21	5	4	6	2	3	1	8	8	0
t22	5	4	6	3	1	2	9	9	0
t23	5	4	6	3	1	2	14	14	0
t11	5	4	6	3	1	2	35	31	4
t12	5	4	6	3	1	2	21	20	1
t13	5	4	6	3	1	2	147	141	6
t21	5	4	6	3	1	2	17	17	0
t22	5	4	6	3	2	1	14	14	0
t23	5	4	6	3	2	1	5	5	0
t11	5	4	6	3	2	1	35	31	4
t12	5	4	6	3	2	1	21	20	1
t13	5	4	6	3	2	1	147	141	6
t21	5	4	6	3	2	1	17	17	0
t22	5	6	1	2	3	4	0	16	-16
t23	5	6	1	2	3	4	0	21	-21
t11	5	6	1	2	3	4	0	31	-31
t12	5	6	1	2	3	4	0	107	-107
t13	5	6	1	2	3	4	0	14	-14
t21	5	6	1	2	3	4	0	7	-7
t22	5	6	1	2	4	3	0	21	-21
t23	5	6	1	2	4	3	0	12	-12
t11	5	6	1	2	4	3	0	31	-31
t12	5	6	1	2	4	3	0	107	-107
t13	5	6	1	2	4	3	0	14	-14
t21	5	6	1	2	4	3	0	7	-7
t22	5	6	1	3	2	4	0	13	-13
t23	5	6	1	3	2	4	0	21	-21
t11	5	6	1	3	2	4	0	31	-31
t12	5	6	1	3	2	4	0	121	-121
t13	5	6	1	3	2	4	0	16	-16
t21	5	6	1	3	2	4	0	16	-16
t22	5	6	1	3	4	2	0	21	-21
t23	5	6	1	3	4	2	0	9	-9
t11	5	6	1	3	4	2	0	31	-31
t12	5	6	1	3	4	2	0	121	-121
t13	5	6	1	3	4	2	0	16	-16
t21	5	6	1	3	4	2	0	12	-12
t22	5	6	1	4	2	3	0	13	-13
t23	5	6	1	4	2	3	0	18	-18
t11	5	6	1	4	2	3	0	31	-31
t12	5	6	1	4	2	3	0	121	-121
t13	5	6	1	4	2	3	0	16	-16
t21	5	6	1	4	2	3	0	21	-21
t22	5	6	1	4	3	2	0	18	-18
t23	5	6	1	4	3	2	0	9	-9
t11	5	6	1	4	3	2	0	31	-31
t12	5	6	1	4	3	2	0	121	-121
t13	5	6	1	4	3	2	0	16	-16
t21	5	6	1	4	3	2	0	21	-21
t22	5	6	2	1	3	4	0	16	-16
t23	5	6	2	1	3	4	0	21	-21
t11	5	6	2	1	3	4	0	31	-31
t12	5	6	2	1	3	4	0	107	-107
t13	5	6	2	1	3	4	0	17	-17
t21	5	6	2	1	3	4	0	3	-3
t22	5	6	2	1	4	3	0	21	-21
t23	5	6	2	1	4	3	0	12	-12
t11	5	6	2	1	4	3	0	31	-31
t12	5	6	2	1	4	3	0	107	-107
t13	5	6	2	1	4	3	0	17	-17
t21	5	6	2	1	4	3	0	3	-3
t22	5	6	2	3	1	4	0	9	-9
t23	5	6	2	3	1	4	0	21	-21
t11	5	6	2	3	1	4	0	31	-31
t12	5	6	2	3	1	4	0	121	-121
t13	5	6	2	3	1	4	0	25	-25
t21	5	6	2	3	1	4	0	16	-16
t22	5	6	2	3	4	1	0	21	-21
t23	5	6	2	3	4	1	0	5	-5
t11	5	6	2	3	4	1	0	31	-31
t12	5	6	2	3	4	1	0	121	-121
t13	5	6	2	3	4	1	0	21	-21
t21	5	6	2	3	4	1	0	12	-12
t22	5	6	2	4	1	3	0	9	-9
t23	5	6	2	4	1	3	0	18	-18
t11	5	6	2	4	1	3	0	31	-31
t12	5	6	2	4	1	3	0	121	-121
t13	5	6	2	4	1	3	0	25	-25
t21	5	6	2	4	1	3	0	21	-21
t22	5	6	2	4	3	1	0	18	-18
t23	5	6	2	4	3	1	0	5	-5
t11	5	6	2	4	3	1	0	31	-31
t12	5	6	2	4	3	1	0	121	-121
t13	5	6	2	4	3	1	0	21	-21
t21	5	6	2	4	3	1	0	21	-21
t22	5	6	3	1	2	4	0	12	-12
t23	5	6	3	1	2	4	0	21	-21
t11	5	6	3	1	2	4	0	31	-31
t12	5	6	3	1	2	4	0	107	-107
t13	5	6	3	1	2	4	0	26	-26
t21	5	6	3	1	2	4	0	3	-3
t22	5	6	3	1	4	2	0	21	-21
t23	5	6	3	1	4	2	0	8	-8
t11	5	6	3	1	4	2	0	31	-31
t12	5	6	3	1	4	2	0	107	-107
t13	5	6	3	1	4	2	0	22	-22
t21	5	6	3	1	4	2	0	3	-3
t22	5	6	3	2	1	4	0	9	-9
t23	5	6	3	2	1	4	0	21	-21
t11	5	6	3	2	1	4	0	31	-31
t12	5	6	3	2	1	4	0	121	-121
t13	5	6	3	2	1	4	0	28	-28
t21	5	6	3	2	1	4	0	12	-12
t22	5	6	3	2	4	1	0	21	-21
t23	5	6	3	2	4	1	0	5	-5
t11	5	6	3	2	4	1	0	31	-31
t12	5	6	3	2	4	1	0	121	-121
t13	5	6	3	2	4	1	0	24	-24
t21	5	6	3	2	4	1	0	8	-8
t22	5	6	3	4	1	2	0	9	-9
t23	5	6	3	4	1	2	0	14	-14
t11	5	6	3	4	1	2	0	31	-31
t12	5	6	3	4	1	2	0	121	-121
t13	5	6	3	4	1	2	0	30	-30
t21	5	6	3	4	1	2	0	21	-21
t22	5	6	3	4	2	1	0	14	-14
t23	5	6	3	4	2	1	0	5	-5
t11	5	6	3	4	2	1	0	31	-31
t12	5	6	3	4	2	1	0	121	-121
t13	5	6	3	4	2	1	0	30	-30
t21	5	6	3	4	2	1	0	21	-21
t22	5	6	4	1	2	3	0	12	-12
t23	5	6	4	1	2	3	0	17	-17
t11	5	6	4	1	2	3	0	31	-31
t12	5	6	4	1	2	3	0	107	-107
t13	5	6	4	1	2	3	0	31	-31
t21	5	6	4	1	2	3	0	3	-3
t22	5	6	4	1	3	2	0	17	-17
t23	5	6	4	1	3	2	0	8	-8
t11	5	6	4	1	3	2	0	31	-31
t12	5	6	4	1	3	2	0	107	-107
t13	5	6	4	1	3	2	0	31	-31
t21	5	6	4	1	3	2	0	3	-3
t22	5	6	4	2	1	3	0	9	-9
t23	5	6	4	2	1	3	0	17	-17
t11	5	6	4	2	1	3	0	31	-31
t12	5	6	4	2	1	3	0	121	-121
t13	5	6	4	2	1	3	0	33	-33
t21	5	6	4	2	1	3	0	12	-12
t22	5	6	4	2	3	1	0	17	-17
t23	5	6	4	2	3	1	0	5	-5
t11	5	6	4	2	3	1	0	31	-31
t12	5	6	4	2	3	1	0	121	-121
t13	5	6	4	2	3	1	0	33	-33
t21	5	6	4	2	3	1	0	8	-8
t22	5	6	4	3	1	2	0	9	-9
t23	5	6	4	3	1	2	0	14	-14
t11	5	6	4	3	1	2	0	31	-31
t12	5	6	4	3	1	2	0	121	-121
t13	5	6	4	3	1	2	0	33	-33
t21	5	6	4	3	1	2	0	17	-17
t22	5	6	4	3	2	1	0	14	-14
t23	5	6	4	3	2	1	0	5	-5
t11	5	6	4	3	2	1	0	31	-31
t12	5	6	4	3	2	1	0	121	-121
t13	5	6	4	3	2	1	0	33	-33
t21	5	6	4	3	2	1	0	17	-17
t22	6	1	2	3	4	5	90	18	72
t23	6	1	2	3	4	5	135	23	112
t11	6	1	2	3	4	5	171	45	126
t12	6	1	2	3	4	5	10	4	6
t13	6	1	2	3	4	5	46	10	36
t21	6	1	2	3	4	5	81	9	72
t22	6	1	2	3	5	4	131	23	108
t23	6	1	2	3	5	4	103	14	89
t11	6	1	2	3	5	4	181	45	136
t12	6	1	2	3	5	4	11	4	7
t13	6	1	2	3	5	4	50	10	40
t21	6	1	2	3	5	4	87	9	78
t22	6	1	2	4	3	5	113	15	98
t23	6	1	2	4	3	5	148	23	125
t11	6	1	2	4	3	5	201	49	152
t12	6	1	2	4	3	5	12	4	8
t13	6	1	2	4	3	5	54	10	44
t21	6	1	2	4	3	5	132	18	114
t22	6	1	2	4	5	3	156	23	133
t23	6	1	2	4	5	3	103	11	92
t11	6	1	2	4	5	3	201	49	152
t12	6	1	2	4	5	3	12	4	8
t13	6	1	2	4	5	3	54	10	44
t21	6	1	2	4	5	3	119	14	105
t22	6	1	2	5	3	4	151	15	136
t23	6	1	2	5	3	4	197	20	177
t11	6	1	2	5	3	4	261	49	212
t12	6	1	2	5	3	4	15	4	11
t13	6	1	2	5	3	4	68	10	58
t21	6	1	2	5	3	4	228	23	205
t22	6	1	2	5	4	3	210	20	190
t23	6	1	2	5	4	3	141	11	130
t11	6	1	2	5	4	3	282	49	233
t12	6	1	2	5	4	3	16	4	12
t13	6	1	2	5	4	3	74	10	64
t21	6	1	2	5	4	3	239	23	216
t22	6	1	3	2	4	5	72	18	54
t23	6	1	3	2	4	5	81	23	58
t11	6	1	3	2	4	5	122	45	77
t12	6	1	3	2	4	5	8	4	4
t13	6	1	3	2	4	5	37	13	24
t21	6	1	3	2	4	5	17	5	12
t22	6	1	3	2	5	4	88	23	65
t23	6	1	3	2	5	4	75	14	61
t11	6	1	3	2	5	4	133	45	88
t12	6	1	3	2	5	4	8	4	4
t13	6	1	3	2	5	4	41	13	28
t21	6	1	3	2	5	4	19	5	14
t22	6	1	3	4	2	5	39	11	28
t23	6	1	3	4	2	5	135	23	112
t11	6	1	3	4	2	5	180	49	131
t12	6	1	3	4	2	5	11	4	7
t13	6	1	3	4	2	5	78	19	59
t21	6	1	3	4	2	5	120	18	102
t22	6	1	3	4	5	2	156	23	133
t23	6	1	3	4	5	2	31	7	24
t11	6	1	3	4	5	2	201	49	152
t12	6	1	3	4	5	2	12	4	8
t13	6	1	3	4	5	2	76	15	61
t21	6	1	3	4	5	2	119	14	105
t22	6	1	3	5	2	4	43	11	32
t23	6	1	3	5	2	4	157	20	137
t11	6	1	3	5	2	4	212	49	163
t12	6	1	3	5	2	4	13	4	9
t13	6	1	3	5	2	4	85	19	66
t21	6	1	3	5	2	4	179	23	156
t22	6	1	3	5	4	2	210	20	190
t23	6	1	3	5	4	2	43	7	36
t11	6	1	3	5	4	2	282	49	233
t12	6	1	3	5	4	2	16	4	12
t13	6	1	3	5	4	2	106	15	91
t21	6	1	3	5	4	2	239	23	216
t22	6	1	4	2	3	5	28	14	14
t23	6	1	4	2	3	5	77	23	54
t11	6	1	4	2	3	5	118	45	73
t12	6	1	4	2	3	5	8	4	4
t13	6	1	4	2	3	5	46	22	24
t21	6	1	4	2	3	5	17	5	12
t22	6	1	4	2	5	3	88	23	65
t23	6	1	4	2	5	3	27	10	17
t11	6	1	4	2	5	3	133	45	88
t12	6	1	4	2	5	3	8	4	4
t13	6	1	4	2	5	3	51	18	33
t21	6	1	4	2	5	3	19	5	14
t22	6	1	4	3	2	5	25	11	14
t23	6	1	4	3	2	5	92	23	69
t11	6	1	4	3	2	5	119	49	70
t12	6	1	4	3	2	5	8	4	4
t13	6	1	4	3	2	5	46	22	24
t21	6	1	4	3	2	5	28	14	14
t22	6	1	4	3	5	2	99	23	76
t23	6	1	4	3	5	2	24	7	17
t11	6	1	4	3	5	2	140	49	91
t12	6	1	4	3	5	2	9	4	5
t13	6	1	4	3	5	2	53	18	35
t21	6	1	4	3	5	2	31	10	21
t22	6	1	4	5	2	3	43	11	32
t23	6	1	4	5	2	3	64	16	48
t11	6	1	4	5	2	3	212	49	163
t12	6	1	4	5	2	3	13	4	9
t13	6	1	4	5	2	3	118	24	94
t21	6	1	4	5	2	3	179	23	156
t22	6	1	4	5	3	2	74	16	58
t23	6	1	4	5	3	2	35	7	28
t11	6	1	4	5	3	2	229	49	180
t12	6	1	4	5	3	2	14	4	10
t13	6	1	4	5	3	2	123	24	99
t21	6	1	4	5	3	2	196	23	173
t22	6	1	5	2	3	4	28	14	14
t23	6	1	5	2	3	4	33	19	14
t11	6	1	5	2	3	4	118	45	73
t12	6	1	5	2	3	4	8	4	4
t13	6	1	5	2	3	4	58	27	31
t21	6	1	5	2	3	4	17	5	12
t22	6	1	5	2	4	3	33	19	14
t23	6	1	5	2	4	3	24	10	14
t11	6	1	5	2	4	3	118	45	73
t12	6	1	5	2	4	3	8	4	4
t13	6	1	5	2	4	3	58	27	31
t21	6	1	5	2	4	3	17	5	12
t22	6	1	5	3	2	4	25	11	14
t23	6	1	5	3	2	4	33	19	14
t11	6	1	5	3	2	4	119	49	70
t12	6	1	5	3	2	4	8	4	4
t13	6	1	5	3	2	4	65	27	38
t21	6	1	5	3	2	4	28	14	14
t22	6	1	5	3	4	2	33	19	14
t23	6	1	5	3	4	2	19	7	12
t11	6	1	5	3	4	2	119	49	70
t12	6	1	5	3	4	2	8	4	4
t13	6	1	5	3	4	2	58	27	31
t21	6	1	5	3	4	2	24	10	14
t22	6	1	5	4	2	3	25	11	14
t23	6	1	5	4	2	3	30	16	14
t11	6	1	5	4	2	3	123	49	74
t12	6	1	5	4	2	3	8	4	4
t13	6	1	5	4	2	3	69	27	42
t21	6	1	5	4	2	3	33	19	14
t22	6	1	5	4	3	2	30	16	14
t23	6	1	5	4	3	2	21	7	14
t11	6	1	5	4	3	2	123	49	74
t12	6	1	5	4	3	2	8	4	4
t13	6	1	5	4	3	2	69	27	42
t21	6	1	5	4	3	2	33	19	14
t22	6	2	1	3	4	5	266	18	248
t23	6	2	1	3	4	5	331	23	308
t11	6	2	1	3	4	5	402	45	357
t12	6	2	1	3	4	5	171	8	163
t13	6	2	1	3	4	5	62	8	54
t21	6	2	1	3	4	5	217	9	208
t22	6	2	1	3	5	4	344	23	321
t23	6	2	1	3	5	4	263	14	249
t11	6	2	1	3	5	4	431	45	386
t12	6	2	1	3	5	4	180	8	172
t13	6	2	1	3	5	4	66	8	58
t21	6	2	1	3	5	4	235	9	226
t22	6	2	1	4	3	5	381	15	366
t23	6	2	1	4	3	5	509	23	486
t11	6	2	1	4	3	5	609	49	560
t12	6	2	1	4	3	5	254	8	246
t13	6	2	1	4	3	5	94	8	86
t21	6	2	1	4	3	5	442	18	424
t22	6	2	1	4	5	3	615	23	592
t23	6	2	1	4	5	3	429	11	418
t11	6	2	1	4	5	3	739	49	690
t12	6	2	1	4	5	3	308	8	300
t13	6	2	1	4	5	3	112	8	104
t21	6	2	1	4	5	3	509	14	495
t22	6	2	1	5	3	4	0	15	-15
t23	6	2	1	5	3	4	0	20	-20
t11	6	2	1	5	3	4	0	49	-49
t12	6	2	1	5	3	4	0	8	-8
t13	6	2	1	5	3	4	0	8	-8
t21	6	2	1	5	3	4	0	23	-23
t22	6	2	1	5	4	3	0	20	-20
t23	6	2	1	5	4	3	0	11	-11
t11	6	2	1	5	4	3	0	49	-49
t12	6	2	1	5	4	3	0	8	-8
t13	6	2	1	5	4	3	0	8	-8
t21	6	2	1	5	4	3	0	23	-23
t22	6	2	3	1	4	5	78	18	60
t23	6	2	3	1	4	5	83	23	60
t11	6	2	3	1	4	5	128	45	83
t12	6	2	3	1	4	5	11	7	4
t13	6	2	3	1	4	5	39	13	26
t21	6	2	3	1	4	5	3	3	0
t22	6	2	3	1	5	4	94	23	71
t23	6	2	3	1	5	4	74	14	60
t11	6	2	3	1	5	4	135	45	90
t12	6	2	3	1	5	4	12	7	5
t13	6	2	3	1	5	4	41	13	28
t21	6	2	3	1	5	4	3	3	0
t22	6	2	3	4	1	5	17	9	8
t23	6	2	3	4	1	5	151	23	128
t11	6	2	3	4	1	5	200	49	151
t12	6	2	3	4	1	5	30	13	17
t13	6	2	3	4	1	5	87	21	66
t21	6	2	3	4	1	5	136	18	118
t22	6	2	3	4	5	1	178	23	155
t23	6	2	3	4	5	1	8	5	3
t11	6	2	3	4	5	1	233	49	184
t12	6	2	3	4	5	1	34	9	25
t13	6	2	3	4	5	1	93	16	77
t21	6	2	3	4	5	1	146	14	132
t22	6	2	3	5	1	4	25	9	16
t23	6	2	3	5	1	4	204	20	184
t11	6	2	3	5	1	4	269	49	220
t12	6	2	3	5	1	4	43	13	30
t13	6	2	3	5	1	4	114	21	93
t21	6	2	3	5	1	4	231	23	208
t22	6	2	3	5	4	1	307	20	287
t23	6	2	3	5	4	1	11	5	6
t11	6	2	3	5	4	1	402	49	353
t12	6	2	3	5	4	1	58	9	49
t13	6	2	3	5	4	1	159	16	143
t21	6	2	3	5	4	1	363	23	340
t22	6	2	4	1	3	5	26	14	12
t23	6	2	4	1	3	5	77	23	54
t11	6	2	4	1	3	5	111	45	66
t12	6	2	4	1	3	5	10	7	3
t13	6	2	4	1	3	5	46	22	24
t21	6	2	4	1	3	5	3	3	0
t22	6	2	4	1	5	3	94	23	71
t23	6	2	4	1	5	3	26	10	16
t11	6	2	4	1	5	3	135	45	90
t12	6	2	4	1	5	3	12	7	5
t13	6	2	4	1	5	3	53	18	35
t21	6	2	4	1	5	3	3	3	0
t22	6	2	4	3	1	5	9	9	0
t23	6	2	4	3	1	5	98	23	75
t11	6	2	4	3	1	5	125	49	76
t12	6	2	4	3	1	5	17	13	4
t13	6	2	4	3	1	5	50	24	26
t21	6	2	4	3	1	5	28	14	14
t22	6	2	4	3	5	1	114	23	91
t23	6	2	4	3	5	1	6	5	1
t11	6	2	4	3	5	1	156	49	107
t12	6	2	4	3	5	1	20	9	11
t13	6	2	4	3	5	1	64	19	45
t21	6	2	4	3	5	1	33	10	23
t22	6	2	4	5	1	3	25	9	16
t23	6	2	4	5	1	3	79	16	63
t11	6	2	4	5	1	3	269	49	220
t12	6	2	4	5	1	3	43	13	30
t13	6	2	4	5	1	3	152	26	126
t21	6	2	4	5	1	3	231	23	208
t22	6	2	4	5	3	1	79	16	63
t23	6	2	4	5	3	1	7	5	2
t11	6	2	4	5	3	1	260	49	211
t12	6	2	4	5	3	1	35	9	26
t13	6	2	4	5	3	1	139	25	114
t21	6	2	4	5	3	1	221	23	198
t22	6	2	5	1	3	4	26	14	12
t23	6	2	5	1	3	4	33	19	14
t11	6	2	5	1	3	4	111	45	66
t12	6	2	5	1	3	4	10	7	3
t13	6	2	5	1	3	4	51	27	24
t21	6	2	5	1	3	4	3	3	0
t22	6	2	5	1	4	3	33	19	14
t23	6	2	5	1	4	3	22	10	12
t11	6	2	5	1	4	3	111	45	66
t12	6	2	5	1	4	3	10	7	3
t13	6	2	5	1	4	3	51	27	24
t21	6	2	5	1	4	3	3	3	0
t22	6	2	5	3	1	4	9	9	0
t23	6	2	5	3	1	4	33	19	14
t11	6	2	5	3	1	4	125	49	76
t12	6	2	5	3	1	4	17	13	4
t13	6	2	5	3	1	4	71	29	42
t21	6	2	5	3	1	4	28	14	14
t22	6	2	5	3	4	1	33	19	14
t23	6	2	5	3	4	1	5	5	0
t11	6	2	5	3	4	1	125	49	76
t12	6	2	5	3	4	1	13	9	4
t13	6	2	5	3	4	1	60	28	32
t21	6	2	5	3	4	1	24	10	14
t22	6	2	5	4	1	3	9	9	0
t23	6	2	5	4	1	3	32	16	16
t11	6	2	5	4	1	3	133	49	84
t12	6	2	5	4	1	3	17	13	4
t13	6	2	5	4	1	3	72	29	43
t21	6	2	5	4	1	3	35	19	16
t22	6	2	5	4	3	1	30	16	14
t23	6	2	5	4	3	1	5	5	0
t11	6	2	5	4	3	1	129	49	80
t12	6	2	5	4	3	1	13	9	4
t13	6	2	5	4	3	1	71	28	43
t21	6	2	5	4	3	1	35	19	16
t22	6	3	1	2	4	5	212	18	194
t23	6	3	1	2	4	5	257	23	234
t11	6	3	1	2	4	5	320	45	275
t12	6	3	1	2	4	5	148	11	137
t13	6	3	1	2	4	5	52	8	44
t21	6	3	1	2	4	5	115	7	108
t22	6	3	1	2	5	4	265	23	242
t23	6	3	1	2	5	4	203	14	189
t11	6	3	1	2	5	4	321	45	276
t12	6	3	1	2	5	4	148	11	137
t13	6	3	1	2	5	4	52	8	44
t21	6	3	1	2	5	4	115	7	108
t22	6	3	1	4	2	5	0	13	-13
t23	6	3	1	4	2	5	0	23	-23
t11	6	3	1	4	2	5	0	49	-49
t12	6	3	1	4	2	5	0	17	-17
t13	6	3	1	4	2	5	0	10	-10
t21	6	3	1	4	2	5	0	18	-18
t22	6	3	1	4	5	2	0	23	-23
t23	6	3	1	4	5	2	0	9	-9
t11	6	3	1	4	5	2	0	49	-49
t12	6	3	1	4	5	2	0	13	-13
t13	6	3	1	4	5	2	0	10	-10
t21	6	3	1	4	5	2	0	14	-14
t22	6	3	1	5	2	4	0	13	-13
t23	6	3	1	5	2	4	0	20	-20
t11	6	3	1	5	2	4	0	49	-49
t12	6	3	1	5	2	4	0	17	-17
t13	6	3	1	5	2	4	0	10	-10
t21	6	3	1	5	2	4	0	23	-23
t22	6	3	1	5	4	2	0	20	-20
t23	6	3	1	5	4	2	0	9	-9
t11	6	3	1	5	4	2	0	49	-49
t12	6	3	1	5	4	2	0	13	-13
t13	6	3	1	5	4	2	0	10	-10
t21	6	3	1	5	4	2	0	23	-23
t22	6	3	2	1	4	5	127	18	109
t23	6	3	2	1	4	5	150	23	127
t11	6	3	2	1	4	5	193	45	148
t12	6	3	2	1	4	5	87	11	76
t13	6	3	2	1	4	5	35	11	24
t21	6	3	2	1	4	5	3	3	0
t22	6	3	2	1	5	4	148	23	125
t23	6	3	2	1	5	4	124	14	110
t11	6	3	2	1	5	4	193	45	148
t12	6	3	2	1	5	4	87	11	76
t13	6	3	2	1	5	4	35	11	24
t21	6	3	2	1	5	4	3	3	0
t22	6	3	2	4	1	5	0	9	-9
t23	6	3	2	4	1	5	0	23	-23
t11	6	3	2	4	1	5	0	49	-49
t12	6	3	2	4	1	5	0	17	-17
t13	6	3	2	4	1	5	0	19	-19
t21	6	3	2	4	1	5	0	18	-18
t22	6	3	2	4	5	1	0	23	-23
t23	6	3	2	4	5	1	0	5	-5
t11	6	3	2	4	5	1	0	49	-49
t12	6	3	2	4	5	1	0	13	-13
t13	6	3	2	4	5	1	0	15	-15
t21	6	3	2	4	5	1	0	14	-14
t22	6	3	2	5	1	4	0	9	-9
t23	6	3	2	5	1	4	0	20	-20
t11	6	3	2	5	1	4	0	49	-49
t12	6	3	2	5	1	4	0	17	-17
t13	6	3	2	5	1	4	0	19	-19
t21	6	3	2	5	1	4	0	23	-23
t22	6	3	2	5	4	1	0	20	-20
t23	6	3	2	5	4	1	0	5	-5
t11	6	3	2	5	4	1	0	49	-49
t12	6	3	2	5	4	1	0	13	-13
t13	6	3	2	5	4	1	0	15	-15
t21	6	3	2	5	4	1	0	23	-23
t22	6	3	4	1	2	5	12	12	0
t23	6	3	4	1	2	5	87	23	64
t11	6	3	4	1	2	5	124	45	79
t12	6	3	4	1	2	5	20	16	4
t13	6	3	4	1	2	5	50	24	26
t21	6	3	4	1	2	5	3	3	0
t22	6	3	4	1	5	2	98	23	75
t23	6	3	4	1	5	2	9	8	1
t11	6	3	4	1	5	2	139	45	94
t12	6	3	4	1	5	2	22	12	10
t13	6	3	4	1	5	2	55	18	37
t21	6	3	4	1	5	2	3	3	0
t22	6	3	4	2	1	5	9	9	0
t23	6	3	4	2	1	5	87	23	64
t11	6	3	4	2	1	5	124	49	75
t12	6	3	4	2	1	5	20	16	4
t13	6	3	4	2	1	5	50	24	26
t21	6	3	4	2	1	5	12	12	0
t22	6	3	4	2	5	1	114	23	91
t23	6	3	4	2	5	1	6	5	1
t11	6	3	4	2	5	1	153	45	108
t12	6	3	4	2	5	1	23	12	11
t13	6	3	4	2	5	1	59	18	41
t21	6	3	4	2	5	1	13	8	5
t22	6	3	4	5	1	2	25	9	16
t23	6	3	4	5	1	2	34	14	20
t11	6	3	4	5	1	2	280	49	231
t12	6	3	4	5	1	2	72	18	54
t13	6	3	4	5	1	2	156	26	130
t21	6	3	4	5	1	2	237	23	214
t22	6	3	4	5	2	1	51	14	37
t23	6	3	4	5	2	1	8	5	3
t11	6	3	4	5	2	1	338	49	289
t12	6	3	4	5	2	1	80	18	62
t13	6	3	4	5	2	1	190	26	164
t21	6	3	4	5	2	1	296	23	273
t22	6	3	5	1	2	4	12	12	0
t23	6	3	5	1	2	4	33	19	14
t11	6	3	5	1	2	4	124	45	79
t12	6	3	5	1	2	4	20	16	4
t13	6	3	5	1	2	4	55	29	26
t21	6	3	5	1	2	4	3	3	0
t22	6	3	5	1	4	2	33	19	14
t23	6	3	5	1	4	2	8	8	0
t11	6	3	5	1	4	2	124	45	79
t12	6	3	5	1	4	2	16	12	4
t13	6	3	5	1	4	2	55	27	28
t21	6	3	5	1	4	2	3	3	0
t22	6	3	5	2	1	4	9	9	0
t23	6	3	5	2	1	4	33	19	14
t11	6	3	5	2	1	4	124	49	75
t12	6	3	5	2	1	4	20	16	4
t13	6	3	5	2	1	4	55	29	26
t21	6	3	5	2	1	4	12	12	0
t22	6	3	5	2	4	1	33	19	14
t23	6	3	5	2	4	1	5	5	0
t11	6	3	5	2	4	1	124	45	79
t12	6	3	5	2	4	1	16	12	4
t13	6	3	5	2	4	1	60	27	33
t21	6	3	5	2	4	1	8	8	0
t22	6	3	5	4	1	2	9	9	0
t23	6	3	5	4	1	2	14	14	0
t11	6	3	5	4	1	2	133	49	84
t12	6	3	5	4	1	2	22	18	4
t13	6	3	5	4	1	2	75	29	46
t21	6	3	5	4	1	2	35	19	16
t22	6	3	5	4	2	1	14	14	0
t23	6	3	5	4	2	1	5	5	0
t11	6	3	5	4	2	1	133	49	84
t12	6	3	5	4	2	1	22	18	4
t13	6	3	5	4	2	1	75	29	46
t21	6	3	5	4	2	1	35	19	16
t22	6	4	1	2	3	5	191	16	175
t23	6	4	1	2	3	5	358	23	335
t11	6	4	1	2	3	5	422	45	377
t12	6	4	1	2	3	5	266	20	246
t13	6	4	1	2	3	5	74	10	64
t21	6	4	1	2	3	5	167	7	160
t22	6	4	1	2	5	3	480	23	457
t23	6	4	1	2	5	3	253	12	241
t11	6	4	1	2	5	3	583	45	538
t12	6	4	1	2	5	3	351	16	335
t13	6	4	1	2	5	3	100	10	90
t21	6	4	1	2	5	3	223	7	216
t22	6	4	1	3	2	5	293	13	280
t23	6	4	1	3	2	5	559	23	536
t11	6	4	1	3	2	5	650	49	601
t12	6	4	1	3	2	5	411	20	391
t13	6	4	1	3	2	5	114	10	104
t21	6	4	1	3	2	5	334	16	318
t22	6	4	1	3	5	2	933	23	910
t23	6	4	1	3	5	2	463	9	454
t11	6	4	1	3	5	2	1115	49	1066
t12	6	4	1	3	5	2	682	16	666
t13	6	4	1	3	5	2	190	10	180
t21	6	4	1	3	5	2	551	12	539
t22	6	4	1	5	2	3	0	13	-13
t23	6	4	1	5	2	3	0	18	-18
t11	6	4	1	5	2	3	0	49	-49
t12	6	4	1	5	2	3	0	22	-22
t13	6	4	1	5	2	3	0	10	-10
t21	6	4	1	5	2	3	0	23	-23
t22	6	4	1	5	3	2	0	18	-18
t23	6	4	1	5	3	2	0	9	-9
t11	6	4	1	5	3	2	0	49	-49
t12	6	4	1	5	3	2	0	22	-22
t13	6	4	1	5	3	2	0	10	-10
t21	6	4	1	5	3	2	0	23	-23
t22	6	4	2	1	3	5	88	16	72
t23	6	4	2	1	3	5	153	23	130
t11	6	4	2	1	3	5	199	45	154
t12	6	4	2	1	3	5	120	20	100
t13	6	4	2	1	3	5	37	13	24
t21	6	4	2	1	3	5	3	3	0
t22	6	4	2	1	5	3	221	23	198
t23	6	4	2	1	5	3	121	12	109
t11	6	4	2	1	5	3	271	45	226
t12	6	4	2	1	5	3	158	16	142
t13	6	4	2	1	5	3	51	13	38
t21	6	4	2	1	5	3	3	3	0
t22	6	4	2	3	1	5	25	9	16
t23	6	4	2	3	1	5	388	23	365
t11	6	4	2	3	1	5	452	49	403
t12	6	4	2	3	1	5	295	20	275
t13	6	4	2	3	1	5	125	19	106
t21	6	4	2	3	1	5	236	16	220
t22	6	4	2	3	5	1	933	23	910
t23	6	4	2	3	5	1	19	5	14
t11	6	4	2	3	5	1	1115	49	1066
t12	6	4	2	3	5	1	682	16	666
t13	6	4	2	3	5	1	285	15	270
t21	6	4	2	3	5	1	551	12	539
t22	6	4	2	5	1	3	0	9	-9
t23	6	4	2	5	1	3	0	18	-18
t11	6	4	2	5	1	3	0	49	-49
t12	6	4	2	5	1	3	0	22	-22
t13	6	4	2	5	1	3	0	19	-19
t21	6	4	2	5	1	3	0	23	-23
t22	6	4	2	5	3	1	0	18	-18
t23	6	4	2	5	3	1	0	5	-5
t11	6	4	2	5	3	1	0	49	-49
t12	6	4	2	5	3	1	0	22	-22
t13	6	4	2	5	3	1	0	15	-15
t21	6	4	2	5	3	1	0	23	-23
t22	6	4	3	1	2	5	12	12	0
t23	6	4	3	1	2	5	141	23	118
t11	6	4	3	1	2	5	172	45	127
t12	6	4	3	1	2	5	111	20	91
t13	6	4	3	1	2	5	43	22	21
t21	6	4	3	1	2	5	3	3	0
t22	6	4	3	1	5	2	221	23	198
t23	6	4	3	1	5	2	10	8	2
t11	6	4	3	1	5	2	271	45	226
t12	6	4	3	1	5	2	158	16	142
t13	6	4	3	1	5	2	74	18	56
t21	6	4	3	1	5	2	3	3	0
t22	6	4	3	2	1	5	9	9	0
t23	6	4	3	2	1	5	147	23	124
t11	6	4	3	2	1	5	188	49	139
t12	6	4	3	2	1	5	115	20	95
t13	6	4	3	2	1	5	46	22	24
t21	6	4	3	2	1	5	12	12	0
t22	6	4	3	2	5	1	227	23	204
t23	6	4	3	2	5	1	7	5	2
t11	6	4	3	2	5	1	282	45	237
t12	6	4	3	2	5	1	168	16	152
t13	6	4	3	2	5	1	76	18	58
t21	6	4	3	2	5	1	18	8	10
t22	6	4	3	5	1	2	0	9	-9
t23	6	4	3	5	1	2	0	14	-14
t11	6	4	3	5	1	2	0	49	-49
t12	6	4	3	5	1	2	0	22	-22
t13	6	4	3	5	1	2	0	24	-24
t21	6	4	3	5	1	2	0	23	-23
t22	6	4	3	5	2	1	0	14	-14
t23	6	4	3	5	2	1	0	5	-5
t11	6	4	3	5	2	1	0	49	-49
t12	6	4	3	5	2	1	0	22	-22
t13	6	4	3	5	2	1	0	24	-24
t21	6	4	3	5	2	1	0	23	-23
t22	6	4	5	1	2	3	12	12	0
t23	6	4	5	1	2	3	17	17	0
t11	6	4	5	1	2	3	128	45	83
t12	6	4	5	1	2	3	25	21	4
t13	6	4	5	1	2	3	59	29	30
t21	6	4	5	1	2	3	3	3	0
t22	6	4	5	1	3	2	17	17	0
t23	6	4	5	1	3	2	8	8	0
t11	6	4	5	1	3	2	128	45	83
t12	6	4	5	1	3	2	25	21	4
t13	6	4	5	1	3	2	59	29	30
t21	6	4	5	1	3	2	3	3	0
t22	6	4	5	2	1	3	9	9	0
t23	6	4	5	2	1	3	17	17	0
t11	6	4	5	2	1	3	128	49	79
t12	6	4	5	2	1	3	25	21	4
t13	6	4	5	2	1	3	59	29	30
t21	6	4	5	2	1	3	12	12	0
t22	6	4	5	2	3	1	17	17	0
t23	6	4	5	2	3	1	5	5	0
t11	6	4	5	2	3	1	128	45	83
t12	6	4	5	2	3	1	25	21	4
t13	6	4	5	2	3	1	59	29	30
t21	6	4	5	2	3	1	8	8	0
t22	6	4	5	3	1	2	9	9	0
t23	6	4	5	3	1	2	14	14	0
t11	6	4	5	3	1	2	132	49	83
t12	6	4	5	3	1	2	25	21	4
t13	6	4	5	3	1	2	59	29	30
t21	6	4	5	3	1	2	17	17	0
t22	6	4	5	3	2	1	14	14	0
t23	6	4	5	3	2	1	5	5	0
t11	6	4	5	3	2	1	132	49	83
t12	6	4	5	3	2	1	25	21	4
t13	6	4	5	3	2	1	64	29	35
t21	6	4	5	3	2	1	17	17	0
t22	6	5	1	2	3	4	0	16	-16
t23	6	5	1	2	3	4	0	21	-21
t11	6	5	1	2	3	4	0	45	-45
t12	6	5	1	2	3	4	0	25	-25
t13	6	5	1	2	3	4	0	10	-10
t21	6	5	1	2	3	4	0	7	-7
t22	6	5	1	2	4	3	0	21	-21
t23	6	5	1	2	4	3	0	12	-12
t11	6	5	1	2	4	3	0	45	-45
t12	6	5	1	2	4	3	0	25	-25
t13	6	5	1	2	4	3	0	10	-10
t21	6	5	1	2	4	3	0	7	-7
t22	6	5	1	3	2	4	0	13	-13
t23	6	5	1	3	2	4	0	21	-21
t11	6	5	1	3	2	4	0	49	-49
t12	6	5	1	3	2	4	0	25	-25
t13	6	5	1	3	2	4	0	10	-10
t21	6	5	1	3	2	4	0	16	-16
t22	6	5	1	3	4	2	0	21	-21
t23	6	5	1	3	4	2	0	9	-9
t11	6	5	1	3	4	2	0	49	-49
t12	6	5	1	3	4	2	0	25	-25
t13	6	5	1	3	4	2	0	10	-10
t21	6	5	1	3	4	2	0	12	-12
t22	6	5	1	4	2	3	0	13	-13
t23	6	5	1	4	2	3	0	18	-18
t11	6	5	1	4	2	3	0	49	-49
t12	6	5	1	4	2	3	0	25	-25
t13	6	5	1	4	2	3	0	10	-10
t21	6	5	1	4	2	3	0	21	-21
t22	6	5	1	4	3	2	0	18	-18
t23	6	5	1	4	3	2	0	9	-9
t11	6	5	1	4	3	2	0	49	-49
t12	6	5	1	4	3	2	0	25	-25
t13	6	5	1	4	3	2	0	10	-10
t21	6	5	1	4	3	2	0	21	-21
t22	6	5	2	1	3	4	127	16	111
t23	6	5	2	1	3	4	146	21	125
t11	6	5	2	1	3	4	270	45	225
t12	6	5	2	1	3	4	204	25	179
t13	6	5	2	1	3	4	54	13	41
t21	6	5	2	1	3	4	3	3	0
t22	6	5	2	1	4	3	146	21	125
t23	6	5	2	1	4	3	128	12	116
t11	6	5	2	1	4	3	270	45	225
t12	6	5	2	1	4	3	204	25	179
t13	6	5	2	1	4	3	58	13	45
t21	6	5	2	1	4	3	3	3	0
t22	6	5	2	3	1	4	49	9	40
t23	6	5	2	3	1	4	591	21	570
t11	6	5	2	3	1	4	996	49	947
t12	6	5	2	3	1	4	773	25	748
t13	6	5	2	3	1	4	276	19	257
t21	6	5	2	3	1	4	542	16	526
t22	6	5	2	3	4	1	0	21	-21
t23	6	5	2	3	4	1	0	5	-5
t11	6	5	2	3	4	1	0	49	-49
t12	6	5	2	3	4	1	0	25	-25
t13	6	5	2	3	4	1	0	15	-15
t21	6	5	2	3	4	1	0	12	-12
t22	6	5	2	4	1	3	0	9	-9
t23	6	5	2	4	1	3	0	18	-18
t11	6	5	2	4	1	3	0	49	-49
t12	6	5	2	4	1	3	0	25	-25
t13	6	5	2	4	1	3	0	19	-19
t21	6	5	2	4	1	3	0	21	-21
t22	6	5	2	4	3	1	0	18	-18
t23	6	5	2	4	3	1	0	5	-5
t11	6	5	2	4	3	1	0	49	-49
t12	6	5	2	4	3	1	0	25	-25
t13	6	5	2	4	3	1	0	15	-15
t21	6	5	2	4	3	1	0	21	-21
t22	6	5	3	1	2	4	12	12	0
t23	6	5	3	1	2	4	129	21	108
t11	6	5	3	1	2	4	229	45	184
t12	6	5	3	1	2	4	156	25	131
t13	6	5	3	1	2	4	61	22	39
t21	6	5	3	1	2	4	3	3	0
t22	6	5	3	1	4	2	146	21	125
t23	6	5	3	1	4	2	9	8	1
t11	6	5	3	1	4	2	270	45	225
t12	6	5	3	1	4	2	204	25	179
t13	6	5	3	1	4	2	73	18	55
t21	6	5	3	1	4	2	3	3	0
t22	6	5	3	2	1	4	9	9	0
t23	6	5	3	2	1	4	129	21	108
t11	6	5	3	2	1	4	233	49	184
t12	6	5	3	2	1	4	156	25	131
t13	6	5	3	2	1	4	68	22	46
t21	6	5	3	2	1	4	12	12	0
t22	6	5	3	2	4	1	163	21	142
t23	6	5	3	2	4	1	6	5	1
t11	6	5	3	2	4	1	301	45	256
t12	6	5	3	2	4	1	222	25	197
t13	6	5	3	2	4	1	77	18	59
t21	6	5	3	2	4	1	13	8	5
t22	6	5	3	4	1	2	0	9	-9
t23	6	5	3	4	1	2	0	14	-14
t11	6	5	3	4	1	2	0	49	-49
t12	6	5	3	4	1	2	0	25	-25
t13	6	5	3	4	1	2	0	24	-24
t21	6	5	3	4	1	2	0	21	-21
t22	6	5	3	4	2	1	0	14	-14
t23	6	5	3	4	2	1	0	5	-5
t11	6	5	3	4	2	1	0	49	-49
t12	6	5	3	4	2	1	0	25	-25
t13	6	5	3	4	2	1	0	24	-24
t21	6	5	3	4	2	1	0	21	-21
t22	6	5	4	1	2	3	12	12	0
t23	6	5	4	1	2	3	17	17	0
t11	6	5	4	1	2	3	229	45	184
t12	6	5	4	1	2	3	156	25	131
t13	6	5	4	1	2	3	78	27	51
t21	6	5	4	1	2	3	3	3	0
t22	6	5	4	1	3	2	17	17	0
t23	6	5	4	1	3	2	8	8	0
t11	6	5	4	1	3	2	229	45	184
t12	6	5	4	1	3	2	156	25	131
t13	6	5	4	1	3	2	78	27	51
t21	6	5	4	1	3	2	3	3	0
t22	6	5	4	2	1	3	9	9	0
t23	6	5	4	2	1	3	17	17	0
t11	6	5	4	2	1	3	233	49	184
t12	6	5	4	2	1	3	156	25	131
t13	6	5	4	2	1	3	78	27	51
t21	6	5	4	2	1	3	12	12	0
t22	6	5	4	2	3	1	17	17	0
t23	6	5	4	2	3	1	5	5	0
t11	6	5	4	2	3	1	233	45	188
t12	6	5	4	2	3	1	156	25	131
t13	6	5	4	2	3	1	78	27	51
t21	6	5	4	2	3	1	8	8	0
t22	6	5	4	3	1	2	9	9	0
t23	6	5	4	3	1	2	14	14	0
t11	6	5	4	3	1	2	233	49	184
t12	6	5	4	3	1	2	156	25	131
t13	6	5	4	3	1	2	78	27	51
t21	6	5	4	3	1	2	17	17	0
t22	6	5	4	3	2	1	14	14	0
t23	6	5	4	3	2	1	5	5	0
t11	6	5	4	3	2	1	233	49	184
t12	6	5	4	3	2	1	156	25	131
t13	6	5	4	3	2	1	78	27	51
t21	6	5	4	3	2	1	17	17	0
